[layer]
type=Tile Layer 1
data=
0,19,0,0,0,17,2,0,0,19,0,
16,18,18,2,18,16,2,0,1,16,1,
17,17,17,17,1,17,0,4,1,1,1,
18,2,16,2,16,16,2,2,18,16,0,
2,2,2,2,2,2,0,5,1,1,1,
0,16,1,16,1,1,16,16,16,16,1,
2,2,2,2,1,4,2,0,6,2,1,
18,18,21,18,0,6,16,1,18,2,1,
0,19,0,0,0,19,19,0,0,24,21,
0,1,24,16,1,16,1,16,0,16,21,
0,19,0,0,24,0,0,0,21,19,0,
1,6,18,16,2,2,1,16,18,18,21,
0,1,2,2,2,2,21,2,7,1,1,
0,0,0,6,1,0,21,1,8,0,0,
24,2,21,1,19,17,4,19,19,6,1,
0,2,0,0,21,7,0,0,0,2,0,
2,17,4,2,17,1,19,19,21,19,24,
21,18,1,16,3,2,18,18,16,2,1,
0,19,0,19,0,0,0,0,0,21,0,
18,16,24,2,0,2,18,18,21,16,1,
0,17,7,17,0,21,0,17,0,0,0,
7,5,0,2,2,2,21,4,1,2,1,
0,2,21,19,17,19,24,19,0,0,0,
18,18,0,18,21,2,8,5,0,16,0,
0,21,0,17,0,17,0,0,0,17,0,
2,2,2,2,1,2,6,1,1,2,0,
2,17,19,19,4,2,19,17,21,19,1,
0,18,18,18,0,0,0,0,0,18,21,
0,1,17,17,0,17,2,2,19,2,21,
0,2,1,18,16,16,1,18,18,2,1,
1,5,6,1,17,17,0,17,17,17,21,
0,0,0,0,0,0,21,2,2,4,0,
2,2,19,19,19,3,17,17,21,19,1,
18,16,0,18,21,2,0,18,0,18,1,
0,21,0,1,19,19,0,19,0,0,0,
18,2,16,1,2,16,18,18,18,4,0,
21,19,17,19,2,2,1,1,17,1,0,
2,0,16,16,2,16,2,2,18,16,1,
0,19,0,0,21,0,0,19,0,0,0,
16,18,0,18,2,16,21,2,0,18,1,
21,0,0,0,3,1,0,0,0,1,0,
16,16,6,6,16,1,16,16,1,5,21,
1,1,6,3,1,0,1,1,1,1,1,
6,6,1,1,1,1,21,3,1,1,0,
0,0,0,2,0,0,0,1,2,2,21,
6,1,0,1,0,1,1,6,21,1,1,
0,1,0,1,0,1,3,21,0,0,0,
0,1,0,6,21,1,1,3,0,1,0,
0,1,0,0,0,21,0,1,3,1,0,
1,1,1,6,1,4,21,1,3,1,0,
0,0,0,0,0,17,21,0,0,17,0,
1,1,0,1,0,5,4,1,0,1,21,
0,1,1,4,0,0,0,1,0,3,21,
0,1,6,1,1,6,7,1,21,1,1,
1,2,5,5,1,2,2,2,0,2,1,
1,1,0,1,1,5,4,1,21,1,0,
0,0,0,17,0,0,0,21,0,17,0,
1,1,1,6,21,1,5,1,1,6,0,
0,17,0,0,0,17,17,0,21,0,0,
7,2,21,2,5,2,5,1,1,2,1,
8,3,5,1,1,4,1,1,1,1,1,
0,0,0,2,2,2,0,0,0,0,21,
5,2,0,2,0,2,0,1,2,1,0,
0,3,0,0,0,1,0,21,0,1,0,
24,1,1,1,1,3,5,4,21,1,1,
0,0,0,16,0,0,21,0,0,16,0,
1,1,21,1,0,1,1,1,4,5,0,
0,16,0,0,0,16,0,0,0,16,0,
1,1,1,3,1,1,0,4,0,1,21,
0,21,0,0,0,1,0,1,0,5,0,
0,1,21,5,0,1,0,3,0,1,0,
0,16,21,16,0,0,0,16,1,16,0,
17,2,0,4,19,2,17,2,17,1,21,
1,1,1,3,5,6,1,1,1,1,0,
0,2,2,2,2,2,1,5,21,1,1,
0,0,1,1,0,0,0,3,0,21,0,
0,0,0,0,0,0,0,0,0,0,0,
0,0,0,0,0,0,0,0,0,0,0,
0,0,0,0,0,0,0,0,0,0,0,
0,0,0,0,0,0,0,0,0,0,0.
[layer]
type=Tile Layer 2
data=
0,200,0,0,0,100,200,0,0,200,0,
100,200,200,200,200,100,200,0,200,100,200,
100,100,100,100,200,100,0,200,200,200,200,
184,184,92,184,92,92,184,184,184,92,0,
184,184,184,184,184,184,0,184,184,184,184,
0,92,184,92,184,184,92,92,92,92,184,
200,200,200,200,200,200,200,0,200,200,200,
200,200,0,200,0,200,100,200,200,200,200,
0,298,0,0,0,298,298,0,0,0,0,
0,273,0,136,273,136,273,136,0,136,0,
0,271,0,0,0,0,0,0,0,271,0,
180,180,180,90,180,180,180,90,180,180,0,
0,291,291,291,291,291,0,291,0,291,291,
0,0,0,289,289,0,0,289,0,0,0,
0,288,0,288,288,144,288,288,288,288,288,
0,264,0,0,0,0,0,0,0,264,0,
262,131,262,262,131,262,262,262,0,262,0,
0,173,173,86,173,173,173,173,86,173,173,
0,187,0,187,0,0,0,0,0,0,0,
279,139,0,279,0,279,279,279,0,139,279,
0,138,0,138,0,0,0,138,0,0,0,
0,253,0,253,253,253,0,253,253,253,253,
0,252,0,252,126,252,0,252,0,0,0,
250,250,0,250,0,250,0,250,0,125,0,
0,0,0,90,0,90,0,0,0,90,0,
179,179,179,179,179,179,179,179,179,179,0,
179,89,179,179,179,179,179,89,0,179,179,
0,164,164,164,0,0,0,0,0,164,0,
0,162,81,81,0,81,162,162,162,162,0,
0,161,161,161,80,80,161,161,161,161,161,
175,175,175,175,87,87,0,87,87,87,0,
0,0,0,0,0,0,0,174,174,174,0,
173,173,173,173,173,173,86,86,0,173,173,
158,79,0,158,0,158,0,158,0,158,158,
0,0,0,157,157,157,0,157,0,0,0,
156,156,78,156,156,78,156,156,156,156,0,
0,169,84,169,169,169,169,169,84,169,0,
168,0,84,84,168,84,168,168,168,84,168,
0,168,0,0,0,0,0,168,0,0,0,
77,154,0,154,154,77,0,154,0,154,154,
0,0,0,0,153,153,0,0,0,153,0,
75,75,151,151,75,151,75,75,151,151,0,
163,163,163,163,163,0,163,163,163,163,163,
163,163,163,163,163,163,0,163,163,163,0,
0,0,0,162,0,0,0,162,162,162,0,
148,148,0,148,0,148,148,148,0,148,148,
0,147,0,147,0,147,147,0,0,0,0,
0,146,0,146,0,146,146,146,0,146,0,
0,157,0,0,0,0,0,157,157,157,0,
156,156,156,156,156,156,0,156,156,156,0,
0,0,0,0,0,77,0,0,0,77,0,
142,142,0,142,0,142,142,142,0,142,0,
0,140,140,140,0,0,0,140,0,140,0,
0,208,208,208,208,208,0,208,0,208,208,
150,150,150,150,150,150,150,150,0,150,150,
150,150,0,150,150,150,150,150,0,150,0,
0,0,0,74,0,0,0,0,0,74,0,
136,136,136,136,0,136,136,136,136,136,0,
0,67,0,0,0,67,67,0,0,0,0,
0,201,0,201,201,201,201,201,201,201,201,
0,216,216,216,216,216,216,216,216,216,216,
0,0,0,144,144,144,0,0,0,0,0,
143,143,0,143,0,143,0,143,143,143,0,
0,132,0,0,0,132,0,0,0,132,0,
0,196,196,196,196,196,196,196,0,196,196,
0,0,0,64,0,0,0,0,0,64,0,
118,118,0,118,0,118,118,118,118,118,0,
0,58,0,0,0,58,0,0,0,58,0,
117,117,117,117,117,117,0,117,0,117,0,
0,0,0,0,0,105,0,105,0,105,0,
0,104,0,104,0,104,0,104,0,104,0,
0,51,0,51,0,0,0,51,103,51,0,
51,102,0,102,102,102,51,102,51,102,0,
101,101,101,101,101,101,101,101,101,101,0,
0,101,101,101,101,101,101,101,0,101,101,
0,0,100,100,0,0,0,100,0,0,0,
0,0,0,0,0,0,0,0,0,0,0,
0,0,0,0,0,0,0,0,0,0,0,
0,0,0,0,0,0,0,0,0,0,0,
0,0,0,0,0,0,0,0,0,0,0.