[layer]
type=Tile Layer 1
data=
1,2,1,0,1,2,1,1,1,1,1,
1,0,1,1,1,1,1,0,0,21,0,
1,0,7,1,1,1,1,1,0,0,0,
0,0,0,1,1,1,1,1,21,0,1,
24,0,0,0,0,1,1,1,1,21,1,
1,2,2,0,0,1,1,1,21,0,1,
1,0,1,1,2,1,1,1,1,1,1,
1,1,1,1,21,1,1,1,1,1,0,
1,0,1,1,2,2,1,1,1,1,1,
1,2,1,21,0,2,1,1,1,1,0,
1,0,0,21,0,1,1,1,1,1,0,
1,0,0,1,1,1,1,1,1,1,0,
0,21,0,1,1,2,1,1,1,0,0,
21,0,1,1,1,1,1,1,1,0,0,
1,0,0,0,21,1,1,1,1,1,0,
1,1,1,1,0,1,1,1,1,1,21,
1,1,1,1,0,1,1,1,1,0,21,
0,0,0,0,0,0,0,0,0,0,0,
0,0,0,0,0,0,0,0,0,0,0,
0,0,0,0,0,0,0,0,0,0,0,
0,0,0,0,0,0,0,0,0,0,0.
[layer]
type=Tile Layer 2
data=
51,51,51,0,51,51,51,51,51,51,51,
78,0,78,78,78,78,78,0,0,0,0,
115,0,0,115,115,115,115,115,0,0,0,
0,0,0,77,77,77,77,77,0,0,77,
0,0,0,0,0,105,105,105,105,0,105,
68,68,68,0,0,68,68,68,0,0,68,
48,0,48,48,48,48,48,48,48,48,48,
50,50,50,50,0,50,50,50,50,50,0,
43,0,43,43,43,43,43,43,43,43,43,
55,55,55,0,0,55,55,55,55,55,0,
54,0,0,0,0,54,54,54,54,54,0,
48,0,0,48,48,48,48,48,48,48,0,
0,0,0,53,53,53,53,53,53,0,0,
0,0,52,52,52,52,52,52,52,0,0,
51,0,0,0,0,51,51,51,51,51,0,
40,40,40,40,0,40,40,40,40,40,0,
44,44,44,44,0,44,44,44,44,0,0,
0,0,0,0,0,0,0,0,0,0,0,
0,0,0,0,0,0,0,0,0,0,0,
0,0,0,0,0,0,0,0,0,0,0,
0,0,0,0,0,0,0,0,0,0,0.