[layer]
type=Tile Layer 1
data=
2,0,2,3,1,1,6,5,1,1,1,
4,1,1,1,1,6,21,1,4,1,1,
0,0,0,0,21,1,0,4,0,0,0,
1,4,0,5,0,1,0,1,21,1,1,
0,21,0,5,0,0,0,2,0,0,0,
0,1,2,3,1,1,1,3,1,2,0,
0,1,1,0,0,5,0,21,0,0,0,
1,1,5,1,21,1,0,5,0,1,1,
0,0,0,1,0,21,0,4,0,0,0,
21,1,0,6,8,1,5,1,1,1,1,
0,6,0,1,0,21,0,0,0,1,0,
1,1,0,1,5,6,1,1,0,1,21,
0,0,0,1,0,21,0,0,0,6,0,
0,0,0,0,0,0,0,0,0,0,0,
0,0,0,0,0,0,0,0,0,0,0,
0,0,0,0,0,0,0,0,0,0,0,
0,0,0,0,0,0,0,0,0,0,0.
[layer]
type=Tile Layer 2
data=
48,0,48,48,48,48,48,48,48,48,48,
48,48,48,48,48,48,0,48,48,48,48,
0,0,0,0,0,68,0,68,0,0,0,
61,61,0,61,0,61,0,61,0,61,61,
0,0,0,60,0,0,0,60,0,0,0,
0,47,47,47,47,47,47,47,47,47,0,
0,53,53,0,0,53,0,0,0,0,0,
47,47,47,47,0,47,0,47,0,47,47,
0,0,0,51,0,0,0,51,0,0,0,
0,67,0,67,0,67,67,67,67,67,67,
0,49,0,49,0,0,0,0,0,49,0,
43,43,0,43,43,43,43,43,0,43,0,
0,0,0,47,0,0,0,0,0,47,0,
0,0,0,0,0,0,0,0,0,0,0,
0,0,0,0,0,0,0,0,0,0,0,
0,0,0,0,0,0,0,0,0,0,0,
0,0,0,0,0,0,0,0,0,0,0.