[layer]
type=Tile Layer 1
data=
0,0,0,0,1,1,1,1,1,1,1,
0,0,0,2,0,0,0,0,0,2,2,
0,0,0,1,21,21,21,4,1,1,1,
0,1,1,1,1,1,1,1,1,1,1,
0,1,1,1,21,21,21,21,1,1,1,
0,0,1,1,1,1,1,1,1,1,1,
0,0,0,1,1,0,0,0,0,1,1,
0,0,0,0,0,0,0,0,0,0,0,
0,0,0,0,0,0,0,0,0,0,0,
0,0,0,0,0,0,0,0,0,0,0,
0,0,0,0,0,0,0,0,0,0,0.
[layer]
type=Tile Layer 2
data=
0,0,0,0,35,35,35,35,35,35,35,
0,0,0,35,0,0,0,0,0,35,35,
0,0,0,35,0,0,0,35,35,35,35,
0,23,23,23,23,23,23,23,23,23,23,
0,33,33,33,0,0,0,0,33,33,33,
0,0,25,25,25,25,25,25,25,25,25,
0,0,0,31,31,0,0,0,0,31,31,
0,0,0,0,0,0,0,0,0,0,0,
0,0,0,0,0,0,0,0,0,0,0,
0,0,0,0,0,0,0,0,0,0,0,
0,0,0,0,0,0,0,0,0,0,0.