[layer]
type=Tile Layer 1
data=
1,1,0,1,1,1,1,1,1,1,1,
1,1,1,0,0,1,1,21,1,1,1,
1,1,0,0,1,1,1,0,0,21,1,
1,1,1,1,1,1,1,1,0,1,1,
1,1,0,21,1,1,1,1,1,0,0,
1,0,0,0,1,1,1,1,1,0,1,
1,21,0,0,1,1,1,1,1,0,0,
0,0,0,0,1,1,1,1,1,1,21,
21,1,1,1,1,1,1,1,1,1,0,
0,0,0,0,1,1,1,1,1,21,0,
1,1,1,0,1,1,1,1,0,0,1,
1,21,0,0,1,1,1,1,1,0,0,
1,21,1,1,1,1,1,1,1,1,0,
1,1,1,1,1,1,1,1,1,0,1,
1,0,0,1,1,1,1,0,0,21,0,
0,0,0,1,1,1,1,21,1,1,1,
0,21,0,1,1,1,1,0,0,1,1,
1,1,0,1,1,0,0,0,21,1,1,
0,0,21,1,1,0,1,1,1,1,1,
0,0,0,0,0,0,0,0,0,0,0,
0,0,0,0,0,0,0,0,0,0,0,
0,0,0,0,0,0,0,0,0,0,0,
0,0,0,0,0,0,0,0,0,0,0.
[layer]
type=Tile Layer 2
data=
60,60,0,60,60,60,60,60,60,60,60,
76,76,76,0,0,76,76,0,76,76,76,
84,84,0,0,84,84,84,0,0,0,84,
64,64,64,64,64,64,64,64,0,64,64,
90,90,0,0,90,90,90,90,90,0,0,
89,0,0,0,89,89,89,89,89,0,89,
82,0,0,0,82,82,82,82,82,0,0,
0,0,0,0,81,81,81,81,81,81,0,
0,64,64,64,64,64,64,64,64,64,0,
0,0,0,0,72,72,72,72,72,0,0,
64,64,64,0,64,64,64,64,0,0,64,
71,0,0,0,71,71,71,71,71,0,0,
50,0,50,50,50,50,50,50,50,50,0,
44,44,44,44,44,44,44,44,44,0,44,
62,0,0,62,62,62,62,0,0,0,0,
0,0,0,61,61,61,61,0,61,61,61,
0,0,0,60,60,60,60,0,0,60,60,
59,59,0,59,59,0,0,0,0,59,59,
0,0,0,58,58,0,58,58,58,58,58,
0,0,0,0,0,0,0,0,0,0,0,
0,0,0,0,0,0,0,0,0,0,0,
0,0,0,0,0,0,0,0,0,0,0,
0,0,0,0,0,0,0,0,0,0,0.