[layer]
type=Tile Layer 1
data=
5,1,4,0,0,0,0,0,21,1,0,
1,1,1,1,0,0,0,21,6,6,1,
3,1,1,1,1,0,21,1,3,6,1,
0,0,0,0,0,0,0,0,21,0,0,
1,0,0,0,0,0,0,21,4,0,0,
1,1,0,0,0,0,21,4,4,1,0,
3,1,1,0,0,21,1,1,6,6,1,
0,0,0,0,0,0,0,0,0,0,0,
0,0,0,0,0,0,0,0,0,0,0,
0,0,0,0,0,0,0,0,0,0,0,
0,0,0,0,0,0,0,0,0,0,0.
[layer]
type=Tile Layer 2
data=
46,46,46,0,0,0,0,0,0,46,0,
46,46,46,46,0,0,0,0,46,46,46,
36,36,36,36,36,0,0,36,36,36,36,
0,0,0,0,0,0,0,0,0,0,0,
43,0,0,0,0,0,0,0,43,0,0,
42,42,0,0,0,0,0,42,42,42,0,
37,37,37,0,0,0,37,37,37,37,37,
0,0,0,0,0,0,0,0,0,0,0,
0,0,0,0,0,0,0,0,0,0,0,
0,0,0,0,0,0,0,0,0,0,0,
0,0,0,0,0,0,0,0,0,0,0.