[layer]
type=Tile Layer 1
data=
0,2,2,3,2,1,2,2,1,1,1,
2,1,5,2,0,1,2,1,1,2,1,
1,1,1,3,0,1,6,1,1,4,1,
0,2,0,2,8,2,1,2,21,4,1,
1,2,2,2,1,1,0,2,2,5,1,
1,2,1,1,2,1,1,2,0,2,1,
2,1,2,5,2,2,6,0,1,1,1,
0,2,0,0,21,0,0,2,8,0,0,
1,2,21,1,1,2,0,2,24,2,1,
0,0,0,1,0,0,21,2,0,2,0,
21,2,4,1,0,1,2,2,0,2,0,
0,2,2,3,24,0,21,2,0,2,0,
1,2,8,1,2,2,21,2,0,1,0,
24,21,0,0,0,0,0,1,0,3,0,
1,6,2,2,1,2,2,1,21,3,24,
0,0,0,2,0,0,8,0,21,2,0,
6,2,0,3,24,1,1,2,2,2,21,
0,2,8,0,0,1,2,0,0,21,0,
3,1,2,0,2,2,3,2,2,1,1,
21,2,1,1,3,5,1,2,2,2,1,
0,0,0,2,21,2,7,0,0,0,0,
1,1,21,2,24,2,0,2,6,2,0,
21,0,0,2,0,1,0,4,2,1,0,
1,4,1,1,0,5,24,1,21,1,1,
7,2,0,21,0,2,0,0,0,0,0,
1,4,21,2,2,2,1,1,2,3,1,
21,2,1,2,1,2,2,1,1,6,1,
0,5,0,0,0,24,21,2,1,2,0,
0,1,0,1,2,1,0,4,2,2,21,
0,2,0,0,0,2,0,24,0,1,0,
0,1,2,2,21,2,4,1,8,2,0,
0,1,5,1,21,0,6,1,0,1,0,
24,2,0,2,21,6,1,2,0,4,0,
0,0,8,1,0,2,21,0,0,2,0,
1,6,1,1,24,5,21,1,1,1,0,
0,0,7,4,0,1,0,21,0,1,0,
4,4,21,1,8,1,1,1,0,1,1,
21,1,0,0,7,1,6,1,0,0,0,
1,6,6,1,1,4,21,1,1,1,1,
1,3,21,1,3,1,8,1,6,1,1,
0,0,0,1,0,6,0,1,24,1,21,
0,0,0,4,21,0,0,1,24,1,0,
1,4,1,1,5,1,0,1,1,1,1,
0,0,0,2,0,0,2,1,21,0,0,
0,1,3,5,24,1,1,1,1,1,21,
1,1,21,2,2,2,3,1,2,3,1,
0,3,0,0,21,0,8,0,0,1,0,
1,1,1,5,1,1,1,3,8,5,21,
1,3,1,5,1,1,1,5,1,1,0,
21,1,1,4,7,5,1,3,1,1,1,
0,0,21,5,8,0,0,1,0,0,0,
1,1,21,1,6,6,0,1,7,1,1,
0,0,0,1,1,1,0,21,0,6,0,
1,1,4,5,21,1,6,1,1,1,0,
0,0,0,0,0,3,8,0,21,1,0,
0,1,2,2,21,2,0,2,7,1,0,
0,0,0,2,21,0,0,2,0,1,0,
1,1,21,1,3,3,5,1,0,1,1,
0,0,21,5,0,0,1,1,0,0,0,
0,1,6,3,21,1,1,1,1,3,1,
0,2,2,2,0,0,0,0,0,0,21,
1,4,0,1,0,1,4,1,21,1,0,
0,0,7,6,0,1,0,21,0,1,0,
21,1,6,1,1,1,0,4,4,1,1,
21,1,5,1,6,1,1,1,1,4,1,
1,1,4,0,1,1,6,1,1,6,1,
0,0,0,0,0,0,0,0,0,0,0,
0,0,0,0,0,0,0,0,0,0,0,
0,0,0,0,0,0,0,0,0,0,0,
0,0,0,0,0,0,0,0,0,0,0.
[layer]
type=Tile Layer 2
data=
0,169,169,169,169,169,169,169,169,169,169,
169,169,169,169,0,169,169,169,169,169,169,
184,184,184,184,0,184,184,184,184,184,184,
0,276,0,276,0,276,276,276,0,276,276,
182,182,182,182,182,182,0,182,182,182,182,
168,168,168,168,168,168,168,168,0,168,168,
168,168,168,168,168,168,168,0,168,168,168,
0,252,0,0,0,0,0,252,0,0,0,
271,271,0,271,271,271,0,271,0,271,271,
0,0,0,180,0,0,0,180,0,180,0,
0,179,179,179,0,179,179,179,0,179,0,
0,246,246,246,0,0,0,246,0,246,0,
243,243,0,243,243,243,0,243,0,243,0,
0,0,0,0,0,0,0,241,0,241,0,
261,261,261,261,261,261,261,261,0,261,0,
0,0,0,259,0,0,0,0,0,259,0,
258,258,0,258,0,258,258,258,258,258,0,
0,235,0,0,0,235,235,0,0,0,0,
156,156,156,0,156,156,156,156,156,156,156,
0,156,156,156,156,156,156,156,156,156,156,
0,0,0,252,0,252,0,0,0,0,0,
250,250,0,250,0,250,0,250,250,250,0,
0,0,0,166,0,166,0,166,166,166,0,
226,226,226,226,0,226,0,226,0,226,226,
0,225,0,0,0,225,0,0,0,0,0,
149,149,0,149,149,149,149,149,149,149,149,
0,161,161,161,161,161,161,161,161,161,161,
0,240,0,0,0,0,0,240,240,240,0,
0,158,0,158,158,158,0,158,158,158,0,
0,217,0,0,0,217,0,0,0,217,0,
0,217,217,217,0,217,217,217,0,217,0,
0,144,144,144,0,0,144,144,0,144,0,
0,232,0,232,0,232,232,232,0,232,0,
0,0,0,231,0,231,0,0,0,231,0,
228,228,228,228,0,228,0,228,228,228,0,
0,0,0,208,0,208,0,0,0,208,0,
207,207,0,207,0,207,207,207,0,207,207,
0,205,0,0,0,205,205,205,0,0,0,
148,148,148,148,148,148,0,148,148,148,148,
219,219,0,219,219,219,0,219,219,219,219,
0,0,0,217,0,217,0,217,0,217,0,
0,0,0,199,0,0,0,199,0,199,0,
132,132,132,132,132,132,0,132,132,132,132,
0,0,0,132,0,0,132,132,0,0,0,
0,213,213,213,0,213,213,213,213,213,0,
140,140,0,140,140,140,140,140,140,140,140,
0,208,0,0,0,0,0,0,0,208,0,
190,190,190,190,190,190,190,190,0,190,0,
126,126,126,126,126,126,126,126,126,126,0,
0,189,189,189,0,189,189,189,189,189,189,
0,0,0,204,0,0,0,204,0,0,0,
201,201,0,201,201,201,0,201,0,201,201,
0,0,0,133,133,133,0,0,0,133,0,
122,122,122,122,0,122,122,122,122,122,0,
0,0,0,0,0,181,0,0,0,181,0,
0,180,180,180,0,180,0,180,0,180,0,
0,0,0,109,0,0,0,109,0,109,0,
108,108,0,108,108,108,108,108,0,108,108,
0,0,0,107,0,0,107,107,0,0,0,
0,96,96,96,0,96,96,96,96,96,96,
0,95,95,95,0,0,0,0,0,0,0,
94,94,0,94,0,94,94,94,0,94,0,
0,0,0,139,0,139,0,0,0,139,0,
0,92,92,92,92,92,0,92,92,92,92,
0,91,91,91,91,91,91,91,91,91,91,
91,91,91,0,91,91,91,91,91,91,91,
0,0,0,0,0,0,0,0,0,0,0,
0,0,0,0,0,0,0,0,0,0,0,
0,0,0,0,0,0,0,0,0,0,0,
0,0,0,0,0,0,0,0,0,0,0.