[layer]
type=Tile Layer 1
data=
0,1,1,6,1,1,1,5,1,1,8,
1,2,1,0,1,2,6,21,1,2,1,
1,0,0,7,0,1,0,0,0,0,1,
1,2,0,0,0,0,0,21,0,2,1,
1,1,3,21,0,7,0,24,4,1,1,
1,1,1,3,7,7,21,4,1,1,1,
2,1,1,1,0,21,0,2,2,1,1,
0,1,1,1,3,21,4,1,1,1,0,
0,8,1,1,1,21,1,1,1,0,0,
0,0,0,0,0,0,0,0,0,0,0,
0,0,0,0,0,0,0,0,0,0,0,
0,0,0,0,0,0,0,0,0,0,0,
0,0,0,0,0,0,0,0,0,0,0.
[layer]
type=Tile Layer 2
data=
0,124,124,124,124,124,124,124,124,124,0,
83,83,83,0,83,83,83,0,83,83,83,
111,0,0,0,0,111,0,0,0,0,111,
74,74,0,0,0,0,0,0,0,74,74,
146,146,146,0,0,0,0,0,146,146,146,
144,144,144,144,0,0,0,144,144,144,144,
71,71,71,71,0,0,0,71,71,71,71,
0,70,70,70,70,0,70,70,70,70,0,
0,0,103,103,103,0,103,103,103,0,0,
0,0,0,0,0,0,0,0,0,0,0,
0,0,0,0,0,0,0,0,0,0,0,
0,0,0,0,0,0,0,0,0,0,0,
0,0,0,0,0,0,0,0,0,0,0.