[layer]
type=Tile Layer 1
data=
1,2,1,21,2,1,2,2,1,1,1,
1,1,0,1,1,1,1,1,1,1,1,
1,2,2,0,16,16,16,2,18,18,1,
1,17,19,0,0,24,19,2,19,1,1,
16,1,16,16,0,1,1,1,1,16,1,
2,17,17,19,21,19,2,1,17,2,1,
2,2,2,1,21,0,0,2,1,2,1,
1,1,1,1,1,1,7,0,21,1,1,
2,16,18,1,18,16,2,1,21,18,1,
1,17,17,17,17,1,1,17,21,1,1,
1,2,1,2,2,2,2,1,21,7,1,
1,1,1,1,1,2,2,2,2,24,21,
16,18,1,1,16,1,2,2,18,1,7,
1,17,1,19,21,19,2,1,19,19,1,
1,1,1,2,21,1,2,2,2,2,1,
19,19,19,19,0,21,0,0,0,19,1,
1,18,18,2,16,18,1,1,21,24,0,
2,19,17,1,2,17,2,1,17,21,24,
2,16,18,18,16,18,1,2,0,21,1,
17,17,1,17,1,17,17,1,21,7,1,
1,1,16,1,16,16,1,16,16,21,1,
17,17,1,1,1,17,17,1,1,21,0,
1,2,0,18,16,2,16,16,2,2,1,
17,0,0,0,21,0,0,0,17,17,1,
16,21,1,2,1,16,16,2,18,2,1,
1,1,2,2,1,2,2,1,2,0,1,
21,2,1,2,16,18,2,16,1,16,1,
21,0,17,17,1,19,19,2,1,2,1,
18,21,0,0,0,2,18,1,16,1,1,
2,2,2,2,0,21,0,0,0,0,2,
1,1,1,1,1,1,1,1,1,21,1,
1,1,1,1,1,1,1,1,1,21,1,
1,1,1,21,1,1,1,1,1,1,1,
1,1,1,21,1,1,1,1,1,1,1,
1,1,1,21,1,1,1,1,1,1,1,
1,1,21,0,1,1,17,17,17,17,1,
1,2,21,1,2,1,1,2,1,2,1,
1,1,0,0,0,0,21,0,1,1,1,
16,16,16,16,1,1,16,21,1,1,1,
1,1,2,1,2,2,1,21,2,2,1,
1,1,1,1,1,1,1,1,0,21,1,
1,1,1,1,1,1,1,21,0,1,1,
1,1,16,16,16,16,16,0,21,0,1,
17,17,1,17,1,17,17,21,24,0,1,
16,1,16,1,1,16,16,21,16,1,1,
1,1,1,1,1,1,1,21,24,0,1,
1,1,1,1,1,1,1,1,0,21,1,
17,17,1,1,17,17,17,1,24,21,1,
0,1,1,1,1,1,1,1,1,1,1,
1,1,1,1,1,1,1,1,1,21,1,
18,16,18,2,1,1,2,18,21,16,1,
2,1,1,1,2,2,2,1,21,0,0,
1,2,2,1,1,1,1,1,2,2,0,
1,1,1,1,1,1,1,1,21,0,0,
1,1,1,1,1,1,21,0,0,1,1,
1,1,1,1,1,1,0,0,0,0,0,
1,1,1,1,1,1,1,1,1,1,21,
1,1,1,2,1,2,1,2,1,2,21,
16,21,16,2,16,2,1,2,2,16,1,
1,0,1,1,1,1,1,1,1,1,1,
24,21,1,1,1,1,1,1,1,1,1,
0,0,0,0,0,0,0,0,0,0,0,
0,0,0,0,0,0,0,0,0,0,0,
0,0,0,0,0,0,0,0,0,0,0,
0,0,0,0,0,0,0,0,0,0,0.
[layer]
type=Tile Layer 2
data=
111,111,111,0,111,111,111,111,111,111,111,
110,110,0,110,110,110,110,110,110,110,110,
110,110,110,0,55,55,55,110,110,110,110,
231,115,231,0,0,0,231,231,231,231,231,
60,120,60,60,0,120,120,120,120,60,120,
120,60,60,120,0,120,120,120,60,120,120,
140,140,140,140,0,0,0,140,140,140,140,
208,208,208,208,208,208,0,0,0,208,208,
108,54,108,108,108,54,108,108,0,108,108,
116,58,58,58,58,116,116,58,0,116,116,
198,198,198,198,198,198,198,198,0,0,198,
196,196,196,196,196,196,196,196,196,0,0,
78,157,157,157,78,157,157,157,157,157,0,
105,52,105,105,0,105,105,105,105,105,105,
104,104,104,104,0,104,104,104,104,104,104,
160,160,160,160,0,0,0,0,0,160,160,
214,214,214,214,107,214,214,214,0,0,0,
189,189,94,189,189,94,189,189,94,0,0,
115,57,115,115,57,115,115,115,0,0,115,
85,85,171,85,171,85,85,171,0,0,171,
99,99,49,99,49,49,99,49,49,0,99,
61,61,122,122,122,61,61,122,122,0,0,
107,107,0,107,53,107,53,53,107,107,107,
75,0,0,0,0,0,0,0,75,75,151,
48,0,97,97,97,48,48,97,97,97,97,
96,96,96,96,96,96,96,96,96,0,96,
0,96,96,96,48,96,96,48,96,48,96,
0,0,59,59,119,119,119,119,119,119,119,
146,0,0,0,0,146,146,146,73,146,146,
145,145,145,145,0,0,0,0,0,0,145,
93,93,93,93,93,93,93,93,93,0,93,
93,93,93,93,93,93,93,93,93,0,93,
92,92,92,0,92,92,92,92,92,92,92,
98,98,98,0,98,98,98,98,98,98,98,
98,98,98,0,98,98,98,98,98,98,98,
110,110,0,0,110,110,55,55,55,55,110,
88,88,0,88,88,88,88,88,88,88,88,
125,125,0,0,0,0,0,0,125,125,125,
43,43,43,43,87,87,43,0,87,87,87,
94,94,94,94,94,94,94,0,94,94,94,
106,106,106,106,106,106,106,106,0,0,106,
104,104,104,104,104,104,104,0,0,104,104,
107,107,53,53,53,53,53,0,0,0,107,
79,79,159,79,159,79,79,0,0,0,159,
41,83,41,83,83,41,41,0,41,83,83,
169,169,169,169,169,169,169,0,0,0,169,
100,100,100,100,100,100,100,100,0,0,100,
75,75,150,150,75,75,75,150,0,0,150,
0,79,79,79,79,79,79,79,79,79,79,
79,79,79,79,79,79,79,79,79,0,79,
78,39,78,78,78,78,78,78,0,39,78,
91,91,91,91,91,91,91,91,0,0,0,
71,71,71,71,71,71,71,71,71,71,0,
90,90,90,90,90,90,90,90,0,0,0,
80,80,80,80,80,80,0,0,0,80,80,
88,88,88,88,88,88,0,0,0,0,0,
62,62,62,62,62,62,62,62,62,62,0,
62,62,62,62,62,62,62,62,62,62,0,
30,0,30,61,30,61,61,61,61,30,61,
60,0,60,60,60,60,60,60,60,60,60,
0,0,102,102,102,102,102,102,102,102,102,
0,0,0,0,0,0,0,0,0,0,0,
0,0,0,0,0,0,0,0,0,0,0,
0,0,0,0,0,0,0,0,0,0,0,
0,0,0,0,0,0,0,0,0,0,0.