[layer]
type=Tile Layer 1
data=
1,0,1,1,1,0,0,1,1,1,0,
1,1,1,1,1,0,5,1,9,1,0,
1,9,1,1,0,0,5,1,1,1,1,
1,1,0,0,0,0,0,0,1,1,0,
1,1,1,1,1,1,0,0,0,1,0,
1,0,0,1,1,1,1,3,0,1,0,
1,1,0,1,9,1,1,1,0,1,0,
1,1,0,1,1,6,1,1,0,1,0,
0,1,0,0,0,0,0,0,0,0,0,
0,0,0,0,0,0,0,0,0,0,0,
0,0,0,0,0,0,0,0,0,0,0.
[layer]
type=Tile Layer 2
data=
60,0,42,30,42,0,0,42,30,42,0,
33,24,24,24,33,0,33,24,24,33,0,
33,24,24,33,0,0,33,24,24,24,33,
42,42,0,0,0,0,0,0,42,42,0,
42,30,30,30,30,42,0,0,0,60,0,
60,0,0,42,30,30,30,42,0,60,0,
37,37,0,37,27,27,27,37,0,54,0,
70,70,0,70,50,50,50,70,0,70,0,
0,60,0,0,0,0,0,0,0,0,0,
0,0,0,0,0,0,0,0,0,0,0,
0,0,0,0,0,0,0,0,0,0,0.