[layer]
type=Tile Layer 1
data=
0,0,21,5,5,0,1,1,0,0,0,
0,21,1,2,0,0,0,3,2,0,0,
21,6,5,0,1,1,1,0,1,1,0,
1,2,0,1,5,3,2,1,0,2,3,
2,21,24,1,6,5,2,1,0,21,1,
2,1,0,5,2,1,5,1,0,2,6,
0,5,1,0,5,4,6,24,4,6,21,
0,0,5,1,0,0,0,1,4,21,0,
0,0,0,5,6,0,5,6,21,0,0,
0,0,0,0,0,0,0,0,0,0,0,
0,0,0,0,0,0,0,0,0,0,0,
0,0,0,0,0,0,0,0,0,0,0,
0,0,0,0,0,0,0,0,0,0,0.
[layer]
type=Tile Layer 2
data=
0,0,0,85,85,0,85,85,0,0,0,
0,0,84,84,0,0,0,84,84,0,0,
0,75,75,0,75,75,75,0,75,75,0,
74,74,0,74,74,74,74,74,0,74,74,
111,0,0,111,111,111,111,111,0,0,111,
72,72,0,72,72,72,72,72,0,72,72,
0,108,108,0,108,108,108,0,108,108,0,
0,0,71,71,0,0,0,71,71,0,0,
0,0,0,70,70,0,70,70,0,0,0,
0,0,0,0,0,0,0,0,0,0,0,
0,0,0,0,0,0,0,0,0,0,0,
0,0,0,0,0,0,0,0,0,0,0,
0,0,0,0,0,0,0,0,0,0,0.