[layer]
type=Tile Layer 1
data=
1,2,2,2,16,3,18,16,0,16,1,
1,17,17,17,1,17,1,6,17,0,1,
16,2,18,1,16,2,0,1,6,18,1,
19,17,21,2,7,17,1,17,2,2,1,
16,2,2,1,0,18,16,1,2,18,1,
0,0,0,19,0,0,0,1,19,8,0,
1,16,8,16,0,1,0,5,16,16,1,
0,6,0,21,0,1,0,0,0,0,0,
0,1,16,18,1,18,2,4,18,4,1,
2,2,8,1,19,1,21,19,17,17,1,
21,16,3,3,24,16,16,6,1,16,1,
21,19,19,19,0,0,0,0,0,0,0,
8,16,21,1,1,16,16,2,2,2,0,
0,19,24,0,0,0,0,0,21,19,0,
24,2,16,16,18,16,2,1,21,2,1,
0,19,0,0,21,17,0,24,0,2,0,
18,2,0,2,24,18,21,16,16,1,0,
0,0,8,2,0,1,0,21,0,2,0,
1,18,16,16,21,18,18,2,0,2,1,
8,0,0,2,0,0,0,2,21,0,0,
1,3,7,1,1,1,21,1,0,6,0,
7,1,0,0,0,19,0,0,21,19,0,
8,2,2,1,21,2,2,1,5,1,1,
0,0,17,17,21,17,0,0,0,0,0,
16,2,16,18,0,18,21,2,1,18,1,
0,0,21,0,0,19,0,19,0,0,0,
0,2,1,2,2,1,21,2,0,3,1,
0,0,0,0,0,19,0,19,21,0,0,
6,1,4,1,21,5,0,1,1,1,1,
0,2,0,0,0,17,0,0,0,19,0,
21,2,0,2,16,16,2,16,0,1,0,
0,19,0,19,0,0,21,0,0,19,0,
4,3,0,1,21,1,1,1,1,3,1,
6,1,4,6,1,1,0,1,1,1,1,
16,16,16,6,6,1,16,5,1,1,21,
21,5,3,1,4,1,1,1,1,1,1,
1,1,21,3,6,1,1,4,1,1,1,
0,0,21,2,0,0,0,2,0,0,0,
16,16,16,16,21,1,0,5,0,16,1,
0,0,0,21,0,1,0,5,0,0,0,
1,1,16,16,16,1,21,5,16,16,1,
0,19,19,0,0,19,21,0,0,0,0,
7,5,1,1,21,1,1,3,1,3,1,
1,0,5,1,1,3,3,1,1,1,1,
2,2,21,2,6,1,0,1,24,2,1,
0,3,0,0,0,2,21,0,0,2,0,
21,1,6,4,0,1,1,1,1,1,0,
0,0,0,19,0,4,19,21,0,0,0,
2,1,21,2,3,2,2,1,4,1,1,
3,1,0,1,1,1,4,1,1,5,21,
1,1,1,6,6,1,1,0,1,1,1,
17,2,19,4,21,17,0,2,19,19,1,
0,1,4,0,21,1,0,0,24,0,0,
0,17,17,17,0,6,1,5,17,1,1,
0,1,0,0,0,1,0,0,6,1,21,
1,1,0,1,6,1,0,5,1,1,21,
21,3,4,5,0,1,1,1,1,1,1,
0,0,0,1,0,0,6,1,0,21,0,
1,1,21,5,1,1,1,1,0,4,0,
1,1,1,1,0,4,1,1,1,6,1,
1,1,1,1,21,1,1,4,4,3,1,
0,0,0,0,0,0,0,0,0,0,0,
0,0,0,0,0,0,0,0,0,0,0,
0,0,0,0,0,0,0,0,0,0,0,
0,0,0,0,0,0,0,0,0,0,0.
[layer]
type=Tile Layer 2
data=
160,160,160,160,80,160,160,80,0,80,160,
160,80,80,80,160,80,160,160,80,0,160,
80,160,160,160,80,160,0,160,160,160,160,
261,130,0,261,0,130,261,130,261,261,261,
86,173,173,173,0,173,86,173,173,173,173,
0,0,0,259,0,0,0,259,259,0,0,
238,119,0,119,0,238,0,238,119,119,238,
0,159,0,0,0,159,0,0,0,0,0,
0,158,79,158,158,158,158,158,158,158,158,
258,258,0,258,258,258,0,258,129,129,258,
0,128,256,256,0,128,128,256,256,128,256,
0,169,169,169,0,0,0,0,0,0,0,
0,116,0,232,232,116,116,232,232,232,0,
0,231,0,0,0,0,0,0,0,231,0,
0,229,114,114,229,114,229,229,0,229,229,
0,247,0,0,0,123,0,0,0,247,0,
244,244,0,244,0,244,0,122,122,244,0,
0,0,0,243,0,243,0,0,0,243,0,
148,148,74,74,0,148,148,148,0,148,148,
0,0,0,220,0,0,0,220,0,0,0,
219,219,0,219,219,219,0,219,0,219,0,
0,235,0,0,0,235,0,0,0,235,0,
0,234,234,234,0,234,234,234,234,234,234,
0,0,77,77,0,77,0,0,0,0,0,
71,142,71,142,0,142,0,142,142,142,142,
0,0,0,0,0,141,0,141,0,0,0,
0,139,139,139,139,139,0,139,0,139,139,
0,0,0,0,0,150,0,150,0,0,0,
149,149,149,149,0,149,0,149,149,149,149,
0,148,0,0,0,74,0,0,0,148,0,
0,136,0,136,68,68,136,68,0,136,0,
0,135,0,135,0,0,0,0,0,135,0,
134,134,0,134,0,134,134,134,134,134,134,
144,144,144,144,144,144,0,144,144,144,144,
72,72,72,144,144,144,72,144,144,144,0,
0,143,143,143,143,143,143,143,143,143,143,
131,131,0,131,131,131,131,131,131,131,131,
0,0,0,130,0,0,0,130,0,0,0,
64,64,64,64,0,128,0,128,0,64,128,
0,0,0,0,0,138,0,138,0,0,0,
137,137,68,68,68,137,0,137,68,68,137,
0,136,136,0,0,136,0,0,0,0,0,
0,186,186,186,0,186,186,186,186,186,186,
123,0,123,123,123,123,123,123,123,123,123,
184,184,0,184,184,184,0,184,0,184,184,
0,132,0,0,0,132,0,0,0,132,0,
0,131,131,131,0,131,131,131,131,131,0,
0,0,0,130,0,130,130,0,0,0,0,
119,119,0,119,119,119,119,119,119,119,119,
117,117,0,117,117,117,117,117,117,117,0,
116,116,116,116,116,116,116,0,116,116,116,
53,107,107,107,0,53,0,107,107,107,107,
0,159,159,0,0,159,0,0,0,0,0,
0,52,52,52,0,105,105,105,52,105,105,
0,95,0,0,0,95,0,0,95,95,0,
94,94,0,94,94,94,0,94,94,94,0,
0,93,93,93,0,93,93,93,93,93,93,
0,0,0,92,0,0,92,92,0,0,0,
91,91,0,91,91,91,91,91,0,91,0,
90,90,90,90,0,90,90,90,90,90,90,
90,90,90,90,0,90,90,90,90,90,90,
0,0,0,0,0,0,0,0,0,0,0,
0,0,0,0,0,0,0,0,0,0,0,
0,0,0,0,0,0,0,0,0,0,0,
0,0,0,0,0,0,0,0,0,0,0.