[layer]
type=Tile Layer 1
data=
1,5,0,1,6,1,0,21,0,0,0,
1,1,21,1,1,3,1,4,6,1,1,
21,0,0,4,1,1,0,0,0,1,1,
0,1,0,1,1,1,1,1,3,5,21,
0,4,0,0,0,21,0,1,1,1,0,
0,1,0,4,3,1,0,1,1,1,21,
0,3,0,1,1,1,0,1,1,3,21,
21,1,0,1,1,6,0,3,1,1,0,
0,5,0,1,1,6,21,1,0,0,0,
0,0,0,0,0,0,0,0,0,0,0,
0,0,0,0,0,0,0,0,0,0,0,
0,0,0,0,0,0,0,0,0,0,0,
0,0,0,0,0,0,0,0,0,0,0.
[layer]
type=Tile Layer 2
data=
47,47,0,47,47,47,0,0,0,0,0,
32,32,0,32,32,32,32,32,32,32,32,
0,0,0,40,40,40,0,0,0,40,40,
0,36,0,36,36,36,36,36,36,36,0,
0,39,0,0,0,0,0,39,39,39,0,
0,38,0,38,38,38,0,38,38,38,0,
0,37,0,37,37,37,0,37,37,37,0,
0,36,0,36,36,36,0,36,36,36,0,
0,36,0,36,36,36,0,36,0,0,0,
0,0,0,0,0,0,0,0,0,0,0,
0,0,0,0,0,0,0,0,0,0,0,
0,0,0,0,0,0,0,0,0,0,0,
0,0,0,0,0,0,0,0,0,0,0.