[layer]
type=Tile Layer 1
data=
21,1,1,1,1,24,1,1,1,1,0,
1,21,1,1,0,1,0,1,1,1,1,
0,0,1,21,0,0,0,1,1,1,1,
0,1,0,1,0,1,0,21,1,1,0,
1,0,1,1,0,21,0,0,1,0,0,
21,0,0,1,0,0,1,1,1,0,0,
0,1,0,1,0,1,0,21,0,0,1,
21,0,1,0,1,0,1,0,1,0,0,
1,1,1,1,0,1,1,1,1,1,1,
1,1,1,1,1,1,0,1,1,1,1,
1,21,0,7,1,0,1,0,0,1,0,
8,1,1,1,0,0,0,0,21,0,0,
0,1,1,1,1,0,1,0,1,21,0,
0,1,0,1,1,0,0,1,0,1,1,
1,0,0,0,0,1,0,1,21,0,1,
0,0,0,0,0,0,0,0,0,0,0,
0,0,0,0,0,0,0,0,0,0,0,
0,0,0,0,0,0,0,0,0,0,0,
0,0,0,0,0,0,0,0,0,0,0.
[layer]
type=Tile Layer 2
data=
0,103,103,103,103,0,103,103,103,103,0,
67,0,67,67,0,67,0,67,67,67,67,
0,0,69,0,0,0,0,69,69,69,69,
0,67,0,67,0,67,0,0,67,67,0,
66,0,66,66,0,0,0,0,66,0,0,
0,0,0,60,0,0,60,60,60,0,0,
0,59,0,59,0,59,0,0,0,0,59,
0,0,58,0,58,0,58,0,58,0,0,
36,36,36,36,0,36,36,36,36,36,36,
36,36,36,36,36,36,0,36,36,36,36,
76,0,0,0,76,0,76,0,0,76,0,
0,75,75,75,0,0,0,0,0,0,0,
0,49,49,49,49,0,49,0,49,0,0,
0,48,0,48,48,0,0,48,0,48,48,
48,0,0,0,0,48,0,48,0,0,48,
0,0,0,0,0,0,0,0,0,0,0,
0,0,0,0,0,0,0,0,0,0,0,
0,0,0,0,0,0,0,0,0,0,0,
0,0,0,0,0,0,0,0,0,0,0.