[layer]
type=Tile Layer 1
data=
6,4,1,21,1,17,17,17,17,0,1,
3,1,1,5,0,4,2,2,2,2,1,
17,1,0,17,17,17,1,1,17,1,1,
2,1,2,0,2,1,1,2,1,1,1,
19,0,2,19,1,1,17,19,17,2,1,
4,2,2,2,1,6,0,2,1,2,1,
2,7,2,21,1,0,2,0,2,1,1,
0,0,16,21,0,0,16,8,0,0,0,
1,21,2,4,1,2,1,2,2,3,1,
18,16,0,2,18,16,2,2,1,16,1,
0,21,0,0,0,0,19,19,0,0,1,
18,2,16,16,2,21,18,16,2,7,1,
0,0,0,19,19,0,24,0,0,0,19,
2,2,1,1,2,2,2,21,4,1,1,
17,4,17,7,2,2,19,17,2,21,1,
0,0,18,8,0,21,0,0,18,0,0,
19,0,0,0,0,21,19,24,0,0,19,
18,16,2,18,1,24,16,18,2,21,1,
21,0,0,0,0,0,19,19,7,0,1,
18,2,2,16,18,3,2,1,0,16,1,
17,17,8,0,0,21,0,0,17,0,0,
2,2,2,2,2,7,1,21,1,0,1,
19,0,21,0,7,0,19,0,0,0,19,
2,21,16,18,18,6,16,2,1,6,1,
7,0,1,0,0,0,0,3,1,0,0,
2,18,16,1,1,2,16,18,0,18,1,
21,0,0,0,17,0,0,0,0,0,17,
2,18,16,21,5,7,18,2,16,1,1,
19,0,0,0,19,0,0,0,0,21,19,
2,0,16,16,6,2,18,16,2,21,1,
19,0,19,21,0,0,0,8,0,0,19,
1,0,16,0,16,1,16,1,4,16,1,
0,0,19,0,19,0,0,0,0,21,0,
1,16,2,0,1,21,18,18,18,0,1,
0,21,0,0,1,0,1,2,2,0,1,
1,1,4,1,4,21,1,0,1,0,1,
1,0,21,0,3,0,0,0,1,0,0,
1,0,1,21,5,1,5,1,1,6,1,
1,0,4,0,1,0,0,0,0,0,21,
3,0,1,0,1,0,1,6,1,1,1,
0,0,1,0,0,0,5,0,0,21,0,
1,16,1,16,1,1,16,21,16,16,1,
5,17,17,21,17,5,1,17,1,1,1,
0,0,0,0,6,0,1,1,1,21,0,
3,2,1,2,2,0,2,21,2,0,1,
0,0,0,0,8,0,2,0,2,0,21,
17,1,17,17,0,1,6,17,1,17,1,
2,8,2,2,6,1,1,2,6,21,1,
0,0,5,0,21,0,0,0,1,0,0,
18,1,18,0,16,2,5,0,18,4,1,
21,0,0,0,17,0,0,0,1,17,1,
1,1,1,5,1,21,1,0,3,0,1,
1,0,4,3,1,1,1,1,1,1,1,
16,21,6,16,1,1,1,1,16,16,1,
0,0,3,0,21,0,0,0,0,0,1,
2,18,16,0,1,18,16,2,6,21,1,
0,0,0,0,5,21,0,0,0,0,1,
5,6,1,1,1,21,1,1,6,1,1,
0,1,3,0,0,21,1,0,0,0,0,
6,2,2,0,2,2,5,21,1,1,1,
1,24,0,0,1,5,0,21,0,0,1,
18,0,0,0,21,0,0,0,0,0,18,
17,17,3,4,17,1,0,1,17,1,1,
3,21,1,5,1,1,1,1,1,4,1,
21,0,1,0,0,0,4,24,1,0,1,
1,1,6,21,1,0,4,0,1,0,1,
0,0,0,0,0,0,0,0,0,0,0,
0,0,0,0,0,0,0,0,0,0,0,
0,0,0,0,0,0,0,0,0,0,0,
0,0,0,0,0,0,0,0,0,0,0.
[layer]
type=Tile Layer 2
data=
175,175,175,0,175,87,87,87,87,0,175,
173,173,173,173,0,173,173,173,173,173,173,
94,188,0,94,94,94,188,188,94,188,188,
188,188,188,0,188,188,188,188,188,188,188,
188,0,188,188,188,188,94,188,94,188,188,
173,173,173,173,173,173,0,173,173,173,173,
259,0,259,0,259,0,259,0,259,259,259,
0,0,129,0,0,0,129,0,0,0,0,
186,0,186,186,186,186,186,186,186,186,186,
185,92,0,185,185,92,185,185,185,92,185,
0,0,0,0,0,0,185,185,0,0,185,
253,253,126,126,253,0,253,126,253,0,253,
0,0,0,252,252,0,0,0,0,0,252,
168,168,168,168,168,168,168,0,168,168,168,
135,271,135,0,271,271,271,135,271,0,271,
0,0,270,0,0,0,0,0,270,0,0,
268,0,0,0,0,0,268,0,0,0,268,
246,123,246,246,246,0,123,246,246,0,246,
0,0,0,0,0,0,243,243,0,0,243,
161,161,161,80,161,161,161,161,0,80,161,
131,131,0,0,0,0,0,0,131,0,0,
261,261,261,261,261,0,261,0,261,0,261,
259,0,0,0,0,0,259,0,0,0,259,
158,0,79,158,158,158,79,158,158,158,158,
0,0,235,0,0,0,0,235,235,0,0,
157,157,78,157,157,157,78,157,0,157,157,
0,0,0,0,85,0,0,0,0,0,85,
253,253,126,0,253,0,253,253,126,253,253,
168,0,0,0,168,0,0,0,0,0,168,
154,0,77,77,154,154,154,77,154,0,154,
229,0,229,0,0,0,0,0,0,0,229,
151,0,75,0,75,151,75,151,151,75,151,
0,0,164,0,164,0,0,0,0,0,0,
163,81,163,0,163,0,163,163,163,0,163,
0,0,0,0,162,0,162,162,162,0,162,
148,148,148,148,148,0,148,0,148,0,148,
147,0,0,0,147,0,0,0,147,0,0,
146,0,146,0,146,146,146,146,146,146,146,
157,0,157,0,157,0,0,0,0,0,0,
156,0,156,0,156,0,156,156,156,156,156,
0,0,156,0,0,0,156,0,0,0,0,
143,71,143,71,143,143,71,0,71,71,143,
142,71,71,0,71,142,142,71,142,142,142,
0,0,0,0,140,0,140,140,140,0,0,
151,151,151,151,151,0,151,0,151,0,151,
0,0,0,0,0,0,225,0,225,0,0,
74,149,74,74,0,149,149,74,149,74,149,
205,0,205,205,205,205,205,205,205,0,205,
0,0,136,0,0,0,0,0,136,0,0,
135,135,135,0,67,135,135,0,135,135,135,
0,0,0,0,73,0,0,0,146,73,146,
145,145,145,145,145,0,145,0,145,0,145,
144,0,144,144,144,144,144,144,144,144,144,
66,0,133,66,133,133,133,133,66,66,133,
0,0,132,0,0,0,0,0,0,0,132,
131,131,65,0,131,131,65,131,131,0,131,
0,0,0,0,119,0,0,0,0,0,119,
118,118,118,118,118,0,118,118,118,118,118,
0,117,117,0,0,0,117,0,0,0,0,
105,105,105,0,105,105,105,0,105,105,105,
156,0,0,0,156,156,0,0,0,0,156,
103,0,0,0,0,0,0,0,0,0,103,
51,51,102,102,51,102,0,102,51,102,102,
102,0,102,102,102,102,102,102,102,102,102,
0,0,151,0,0,0,151,0,151,0,151,
100,100,100,0,100,0,100,0,100,0,100,
0,0,0,0,0,0,0,0,0,0,0,
0,0,0,0,0,0,0,0,0,0,0,
0,0,0,0,0,0,0,0,0,0,0,
0,0,0,0,0,0,0,0,0,0,0.