[layer]
type=Tile Layer 1
data=
0,0,0,21,4,21,6,21,0,0,0,
0,0,21,0,1,3,3,0,21,0,0,
0,0,0,1,1,1,3,5,0,0,0,
0,4,3,1,6,4,5,1,3,3,0,
0,21,5,1,5,1,1,5,1,21,0,
0,5,1,1,3,4,4,3,6,6,0,
0,0,0,1,1,4,1,3,0,0,0,
0,0,21,0,5,1,6,0,21,0,0,
0,0,0,0,5,21,6,0,0,0,0,
0,0,0,0,0,0,0,0,0,0,0,
0,0,0,0,0,0,0,0,0,0,0,
0,0,0,0,0,0,0,0,0,0,0,
0,0,0,0,0,0,0,0,0,0,0.
[layer]
type=Tile Layer 2
data=
0,0,0,0,62,0,62,0,0,0,0,
0,0,0,0,59,59,59,0,0,0,0,
0,0,0,51,51,51,51,51,0,0,0,
0,41,41,41,41,41,41,41,41,41,0,
0,0,51,51,51,51,51,51,51,0,0,
0,39,39,39,39,39,39,39,39,39,0,
0,0,0,49,49,49,49,49,0,0,0,
0,0,0,0,49,49,49,0,0,0,0,
0,0,0,0,47,0,47,0,0,0,0,
0,0,0,0,0,0,0,0,0,0,0,
0,0,0,0,0,0,0,0,0,0,0,
0,0,0,0,0,0,0,0,0,0,0,
0,0,0,0,0,0,0,0,0,0,0.