[layer]
type=Tile Layer 1
data=
1,2,0,0,1,1,1,7,0,2,1,
0,1,2,0,1,1,2,0,1,0,0,
0,0,1,1,0,1,0,1,1,0,0,
0,0,0,2,4,1,3,2,0,0,0,
0,0,0,1,1,1,1,3,0,0,0,
0,0,0,2,1,0,1,2,0,0,0,
0,21,0,2,1,1,1,2,0,21,0,
0,0,1,1,0,0,0,1,1,0,0,
0,2,1,0,0,0,0,0,2,1,0,
0,1,8,0,1,1,1,0,0,1,0,
21,2,0,0,1,1,2,0,8,1,21,
1,1,0,0,1,1,1,0,0,7,1,
1,1,0,23,0,0,0,23,0,1,1,
0,1,1,1,1,1,1,1,1,1,0,
0,0,1,1,1,1,1,1,1,0,0,
0,21,0,1,1,21,1,1,0,21,0,
0,0,0,0,1,21,1,0,0,0,0,
0,0,0,0,0,0,0,0,0,0,0,
0,0,0,0,0,0,0,0,0,0,0,
0,0,0,0,0,0,0,0,0,0,0,
0,0,0,0,0,0,0,0,0,0,0.
[layer]
type=Tile Layer 2
data=
160,160,0,0,160,160,160,0,0,160,160,
0,116,116,0,116,116,116,0,116,0,0,
0,0,116,116,0,116,0,116,116,0,0,
0,0,0,116,116,116,116,116,0,0,0,
0,0,0,107,107,107,107,107,0,0,0,
0,0,0,107,107,0,107,107,0,0,0,
0,0,0,107,107,107,107,107,0,0,0,
0,0,96,96,0,0,0,96,96,0,0,
0,96,96,0,0,0,0,0,96,96,0,
0,144,0,0,144,144,144,0,0,144,0,
0,130,0,0,130,130,130,0,0,130,0,
127,127,0,0,127,127,127,0,0,0,127,
85,85,0,0,0,0,0,0,0,85,85,
0,83,83,83,83,83,83,83,83,83,0,
0,0,83,83,83,83,83,83,83,0,0,
0,0,0,83,83,0,83,83,0,0,0,
0,0,0,0,80,0,80,0,0,0,0,
0,0,0,0,0,0,0,0,0,0,0,
0,0,0,0,0,0,0,0,0,0,0,
0,0,0,0,0,0,0,0,0,0,0,
0,0,0,0,0,0,0,0,0,0,0.