[layer]
type=Tile Layer 1
data=
1,0,0,0,0,0,0,0,1,0,1,
0,21,1,0,1,1,0,1,0,0,0,
1,0,0,1,1,1,1,1,21,0,1,
1,0,0,21,1,1,1,1,0,0,0,
0,1,0,1,1,21,1,0,1,0,0,
1,0,0,1,1,0,0,1,0,1,1,
0,0,1,1,0,1,1,0,1,21,0,
1,0,0,0,0,21,1,1,0,0,1,
0,1,0,1,1,21,0,0,0,0,1,
1,0,21,1,1,1,0,0,1,0,1,
1,1,0,1,1,1,1,1,1,1,1,
1,1,1,1,1,0,1,1,1,1,1,
1,1,0,0,0,0,0,21,0,0,1,
0,1,1,0,0,1,0,1,0,0,21,
1,1,0,0,1,0,0,0,21,1,1,
1,21,0,0,0,0,1,1,0,0,0,
21,1,1,0,1,0,0,1,1,0,0,
0,1,0,0,1,0,0,0,0,1,21,
0,1,0,1,0,0,0,0,0,1,21,
0,0,0,0,0,0,0,0,0,0,0,
0,0,0,0,0,0,0,0,0,0,0,
0,0,0,0,0,0,0,0,0,0,0,
0,0,0,0,0,0,0,0,0,0,0.
[layer]
type=Tile Layer 2
data=
86,0,0,0,0,0,0,0,86,0,86,
0,0,86,0,86,86,0,86,0,0,0,
85,0,0,85,85,85,85,85,0,0,85,
91,0,0,0,91,91,91,91,0,0,0,
0,90,0,90,90,0,90,0,90,0,0,
89,0,0,89,89,0,0,89,0,89,89,
0,0,82,82,0,82,82,0,82,0,0,
81,0,0,0,0,0,81,81,0,0,81,
0,79,0,79,79,0,0,0,0,0,79,
72,0,0,72,72,72,0,0,72,0,72,
50,50,0,50,50,50,50,50,50,50,50,
50,50,50,50,50,0,50,50,50,50,50,
64,64,0,0,0,0,0,0,0,0,64,
0,63,63,0,0,63,0,63,0,0,0,
62,62,0,0,62,0,0,0,0,62,62,
61,0,0,0,0,0,61,61,0,0,0,
0,60,60,0,60,0,0,60,60,0,0,
0,59,0,0,59,0,0,0,0,59,0,
0,58,0,58,0,0,0,0,0,58,0,
0,0,0,0,0,0,0,0,0,0,0,
0,0,0,0,0,0,0,0,0,0,0,
0,0,0,0,0,0,0,0,0,0,0,
0,0,0,0,0,0,0,0,0,0,0.