[layer]
type=Tile Layer 1
data=
1,1,1,2,4,0,2,2,2,2,1,
2,1,2,1,0,2,2,2,1,1,1,
6,2,1,1,0,2,2,1,5,2,1,
4,1,1,0,4,1,4,1,1,1,1,
2,2,2,0,0,0,2,0,1,8,1,
1,2,2,2,0,2,5,2,4,1,1,
2,2,2,0,2,0,24,0,0,0,0,
1,5,2,0,2,1,2,1,4,2,1,
0,0,0,0,21,7,4,1,6,1,1,
2,2,3,2,2,0,8,0,0,21,0,
1,1,2,2,2,0,0,21,2,2,1,
2,2,2,2,3,0,21,24,1,2,1,
2,2,2,1,2,1,2,21,6,1,1,
5,0,1,2,2,1,6,2,1,2,1,
5,0,0,24,1,0,0,0,1,21,1,
2,2,2,6,1,2,5,1,2,21,1,
0,0,0,1,21,2,1,2,1,5,0,
21,1,1,3,7,1,1,1,1,3,0,
1,1,2,1,1,1,21,2,2,2,24,
21,1,1,1,0,1,7,5,1,5,0,
21,1,1,2,7,1,0,2,2,2,1,
0,24,21,2,1,6,0,2,2,1,1,
21,7,0,2,2,1,0,1,0,0,0,
0,21,7,3,1,3,0,1,2,2,0,
24,0,21,1,1,5,0,4,1,1,0,
0,0,21,1,1,2,0,1,5,2,0,
0,24,0,5,0,0,21,2,2,1,0,
21,6,1,1,0,0,24,1,5,1,0,
24,1,1,2,2,2,3,1,1,2,21,
1,2,21,1,1,2,2,2,24,5,1,
0,2,0,2,4,2,5,1,21,0,0,
0,1,21,1,6,1,2,2,1,2,0,
2,6,5,0,1,2,2,2,1,1,1,
0,4,1,1,1,3,21,6,1,1,1,
0,2,2,5,0,0,8,1,2,2,21,
0,2,1,2,7,1,0,2,4,2,0,
2,2,2,1,21,1,1,2,24,5,0,
0,1,0,0,0,1,0,2,0,2,21,
0,1,1,3,4,1,0,1,1,1,21,
0,1,1,1,1,3,21,1,5,1,0,
0,1,1,6,4,1,21,1,1,1,0,
1,1,2,1,2,2,1,3,3,2,21,
21,1,6,1,1,1,4,1,3,1,1,
0,1,24,0,0,1,1,4,0,0,21,
0,4,6,1,21,4,1,1,1,1,1,
1,4,21,6,1,3,1,1,1,1,1,
0,5,0,2,2,1,2,1,0,0,21,
1,3,7,5,1,5,1,1,21,1,1,
0,0,0,1,1,1,3,6,0,1,21,
0,0,0,4,1,1,3,1,21,1,1,
0,0,21,2,0,2,4,1,0,2,1,
0,0,21,1,24,6,1,1,0,5,0,
2,3,2,1,2,1,2,6,21,4,0,
1,1,1,6,0,0,0,0,0,6,0,
6,1,1,6,1,1,21,4,7,1,1,
1,1,1,1,0,3,0,4,0,21,0,
3,1,1,1,0,1,1,3,6,1,21,
6,1,1,1,21,3,1,5,1,1,8,
3,1,1,1,0,3,1,1,21,1,0,
3,1,1,1,21,3,1,1,0,1,0,
1,5,5,2,0,2,2,1,0,2,21,
1,1,4,6,1,5,1,1,0,1,21,
0,5,1,6,0,0,21,1,0,1,0,
0,1,6,1,0,0,0,1,21,4,0,
0,2,2,2,0,0,0,2,21,3,0,
0,1,4,1,1,1,1,5,21,1,0,
0,2,2,2,0,0,0,0,21,2,0,
5,2,2,1,0,1,1,2,4,2,21,
21,0,0,0,0,5,1,1,6,1,0,
0,1,21,5,4,1,1,1,0,1,1,
21,0,0,4,0,1,1,1,0,5,0,
0,0,0,0,0,0,0,0,0,0,0,
0,0,0,0,0,0,0,0,0,0,0,
0,0,0,0,0,0,0,0,0,0,0,
0,0,0,0,0,0,0,0,0,0,0.
[layer]
type=Tile Layer 2
data=
126,126,126,126,126,0,126,126,126,126,126,
137,137,137,137,0,137,137,137,137,137,137,
137,137,137,137,0,137,137,137,137,137,137,
137,137,137,0,137,137,137,137,137,137,137,
267,267,267,0,0,0,267,0,267,0,267,
126,126,126,126,0,126,126,126,126,126,126,
267,267,267,0,267,0,0,0,0,0,0,
137,137,137,0,137,137,137,137,137,137,137,
0,0,0,0,0,0,291,291,291,291,291,
289,289,289,289,289,0,0,0,0,0,0,
159,159,159,159,159,0,0,0,159,159,159,
237,237,237,237,237,0,0,0,237,237,237,
122,122,122,122,122,122,122,0,122,122,122,
132,0,132,132,132,132,132,132,132,132,132,
282,0,0,0,282,0,0,0,282,0,282,
132,132,132,132,132,132,132,132,132,0,132,
0,0,0,171,0,171,171,171,171,171,0,
0,228,228,228,0,228,228,228,228,228,0,
204,204,204,204,204,204,0,204,204,204,0,
0,273,273,273,0,273,0,273,273,273,0,
0,244,244,244,0,244,0,244,244,244,244,
0,0,0,270,270,270,0,270,270,270,270,
0,0,0,246,246,246,0,246,0,0,0,
0,0,0,244,244,244,0,244,244,244,0,
0,0,0,243,243,243,0,243,243,243,0,
0,0,0,175,175,175,0,175,175,175,0,
0,0,0,261,0,0,0,261,261,261,0,
0,259,259,259,0,0,0,259,259,259,0,
0,190,190,190,190,190,190,190,190,190,0,
189,189,0,189,189,189,189,189,0,189,189,
0,155,0,155,155,155,155,155,0,0,0,
0,151,0,151,151,151,151,151,151,151,0,
118,118,118,0,118,118,118,118,118,118,118,
0,133,133,133,133,133,0,133,133,133,133,
0,228,228,228,0,0,0,228,228,228,0,
0,226,226,226,0,226,0,226,226,226,0,
204,204,204,204,0,204,204,204,0,204,0,
0,163,0,0,0,163,0,163,0,163,0,
0,145,145,145,145,145,0,145,145,145,0,
0,144,144,144,144,144,0,144,144,144,0,
0,132,132,132,132,132,0,132,132,132,0,
103,103,103,103,103,103,103,103,103,103,0,
0,101,101,101,101,101,101,101,101,101,101,
0,234,0,0,0,234,234,234,0,0,0,
0,124,124,124,0,124,124,124,124,124,124,
108,108,0,108,108,108,108,108,108,108,108,
0,140,0,140,140,140,140,140,0,0,0,
166,166,0,166,166,166,166,166,0,166,166,
0,0,0,138,138,138,138,138,0,138,0,
0,0,0,149,149,149,149,149,0,149,149,
0,0,0,148,0,148,148,148,0,148,148,
0,0,0,219,0,219,219,219,0,219,0,
107,107,107,107,107,107,107,107,0,107,0,
132,132,132,132,0,0,0,0,0,132,0,
159,159,159,159,159,159,0,159,0,159,159,
143,143,143,143,0,143,0,143,0,0,0,
114,114,114,114,0,114,114,114,114,114,0,
169,169,169,169,0,169,169,169,169,169,0,
115,115,115,115,0,115,115,115,0,115,0,
114,114,114,114,0,114,114,114,0,114,0,
112,112,112,112,0,112,112,112,0,112,0,
92,92,92,92,92,92,92,92,0,92,0,
0,113,113,113,0,0,0,113,0,113,0,
0,112,112,112,0,0,0,112,0,112,0,
0,100,100,100,0,0,0,100,0,100,0,
0,89,89,89,89,89,89,89,0,89,0,
0,98,98,98,0,0,0,0,0,98,0,
78,78,78,78,0,78,78,78,78,78,0,
0,0,0,0,0,96,96,96,96,96,0,
0,85,0,85,85,85,85,85,0,85,85,
0,0,0,94,0,94,94,94,0,94,0,
0,0,0,0,0,0,0,0,0,0,0,
0,0,0,0,0,0,0,0,0,0,0,
0,0,0,0,0,0,0,0,0,0,0,
0,0,0,0,0,0,0,0,0,0,0.