[layer]
type=Tile Layer 1
data=
21,1,1,16,1,1,1,16,1,1,7,
21,1,1,1,1,17,1,1,17,1,21,
7,0,0,1,1,21,1,1,0,0,0,
8,0,0,1,1,21,1,1,7,0,0,
0,21,1,1,1,1,1,1,1,21,0,
24,21,1,1,17,1,1,1,1,8,0,
0,0,0,0,1,1,1,0,7,0,0,
0,0,0,0,0,1,0,0,0,0,0,
0,0,0,0,1,1,1,0,0,0,0,
0,0,0,0,0,0,0,0,0,0,0,
0,0,0,0,0,0,0,0,0,0,0,
0,0,0,0,0,0,0,0,0,0,0,
0,0,0,0,0,0,0,0,0,0,0.
[layer]
type=Tile Layer 2
data=
0,126,126,63,126,126,126,63,126,126,0,
0,83,83,83,83,41,83,83,41,83,0,
0,0,0,109,109,0,109,109,0,0,0,
0,0,0,144,144,0,144,144,0,0,0,
0,0,71,71,71,71,71,71,71,0,0,
0,0,138,138,69,138,138,138,138,0,0,
0,0,0,0,103,103,103,0,0,0,0,
0,0,0,0,0,69,0,0,0,0,0,
0,0,0,0,69,69,69,0,0,0,0,
0,0,0,0,0,0,0,0,0,0,0,
0,0,0,0,0,0,0,0,0,0,0,
0,0,0,0,0,0,0,0,0,0,0,
0,0,0,0,0,0,0,0,0,0,0.