[layer]
type=Tile Layer 1
data=
0,5,2,1,2,2,2,2,1,3,1,
1,1,1,1,0,3,1,5,7,1,0,
4,1,1,2,2,0,1,2,2,2,1,
0,1,2,2,1,1,3,2,2,6,1,
7,6,1,1,1,1,1,6,6,1,1,
1,0,1,5,1,2,2,2,2,5,1,
0,0,0,2,0,2,24,0,0,0,0,
1,2,21,2,0,2,0,3,4,2,0,
7,0,21,6,0,2,0,0,0,2,0,
1,3,1,1,2,2,2,2,21,6,24,
2,1,2,1,0,1,3,2,2,2,1,
2,1,2,2,6,2,21,1,24,1,0,
0,1,0,24,21,5,0,0,0,1,0,
7,1,21,1,0,1,1,3,3,1,1,
1,6,5,5,1,1,0,1,1,1,1,
2,1,2,4,1,2,2,3,1,1,21,
7,6,2,2,1,3,1,2,4,2,21,
4,1,1,2,2,1,5,2,2,2,0,
1,1,1,1,2,1,2,2,1,2,21,
5,1,2,1,0,2,1,2,8,2,21,
0,1,0,0,0,3,0,21,7,1,0,
2,3,8,3,0,1,0,2,2,2,21,
0,0,0,2,0,1,0,21,0,2,0,
1,3,1,3,8,4,1,1,21,1,1,
0,0,0,2,0,2,6,1,0,0,0,
0,2,0,5,7,1,21,2,2,1,0,
1,1,0,3,1,1,3,1,6,1,1,
1,1,1,1,2,2,8,2,0,2,21,
0,1,0,7,0,0,0,1,21,5,0,
0,2,24,1,2,6,2,3,21,2,1,
0,0,8,4,0,0,0,0,21,1,0,
2,1,1,3,8,2,1,2,2,1,21,
21,0,8,2,0,2,1,0,0,0,0,
0,3,21,2,0,2,2,1,8,2,1,
0,5,2,2,0,0,0,2,21,2,0,
1,1,1,1,1,6,24,6,21,1,0,
0,2,21,7,0,0,0,2,0,1,0,
0,1,7,6,3,1,1,1,21,1,1,
0,6,0,0,7,0,0,21,0,1,0,
7,1,3,4,1,1,1,1,1,4,21,
1,1,1,1,1,1,3,5,3,1,0,
21,1,1,1,8,1,6,1,6,4,1,
0,0,2,2,8,2,21,0,0,0,0,
0,1,0,0,0,5,8,21,0,0,0,
1,3,1,1,1,6,1,0,1,1,1,
0,1,0,3,1,0,21,1,0,24,0,
1,6,8,3,1,1,0,1,21,1,1,
0,1,21,0,0,1,0,6,0,24,0,
21,1,5,5,8,1,0,1,1,1,1,
2,6,0,2,1,1,1,5,2,2,1,
2,2,0,2,0,1,8,3,1,2,21,
21,0,0,3,0,0,0,1,1,1,0,
6,1,21,2,2,1,2,1,0,2,1,
0,1,0,1,5,21,0,0,0,1,0,
21,1,0,4,1,1,3,1,0,1,0,
0,1,7,21,0,0,0,0,0,3,0,
21,2,2,2,1,2,1,5,7,1,0,
0,0,0,3,0,0,0,2,1,2,0,
2,1,21,2,0,2,0,2,5,1,0,
0,1,0,0,0,6,0,0,0,21,0,
21,2,1,1,5,2,1,1,2,2,1,
2,1,2,5,21,2,2,2,5,1,1,
0,4,0,0,0,1,0,1,1,0,21,
24,1,0,1,1,1,21,1,3,3,1,
0,1,0,4,1,1,0,0,0,21,0,
1,5,21,1,7,1,3,5,1,1,1,
0,0,0,0,0,0,0,0,0,0,0,
0,0,0,0,0,0,0,0,0,0,0,
0,0,0,0,0,0,0,0,0,0,0,
0,0,0,0,0,0,0,0,0,0,0.
[layer]
type=Tile Layer 2
data=
0,164,164,164,164,164,164,164,164,164,164,
246,246,246,246,0,246,246,246,0,246,0,
178,178,178,178,178,0,178,178,178,178,178,
0,178,178,178,178,178,178,178,178,178,178,
0,267,267,267,267,267,267,267,267,267,267,
164,0,164,164,164,164,164,164,164,164,164,
0,0,0,246,0,246,0,0,0,0,0,
164,164,0,164,0,164,0,164,164,164,0,
0,0,0,264,0,264,0,0,0,264,0,
262,262,262,262,262,262,262,262,0,262,0,
174,174,174,174,0,174,174,174,174,174,174,
240,240,240,240,240,240,0,240,0,240,0,
0,238,0,0,0,238,0,0,0,238,0,
0,237,0,237,0,237,237,237,237,237,237,
170,170,170,170,170,170,0,170,170,170,170,
170,170,170,170,170,170,170,170,170,170,0,
0,253,253,253,253,253,253,253,253,253,0,
155,155,155,155,155,155,155,155,155,155,0,
155,155,155,155,155,155,155,155,155,155,0,
231,231,231,231,0,231,231,231,0,231,0,
0,249,0,0,0,249,0,0,0,249,0,
246,246,0,246,0,246,0,246,246,246,0,
0,0,0,163,0,163,0,0,0,163,0,
223,223,223,223,0,223,223,223,0,223,223,
0,0,0,148,0,148,148,148,0,0,0,
0,222,0,222,0,222,0,222,222,222,0,
160,160,0,160,160,160,160,160,160,160,160,
240,240,240,240,240,240,0,240,0,240,0,
0,237,0,0,0,0,0,237,0,237,0,
0,217,0,217,217,217,217,217,0,217,217,
0,0,0,216,0,0,0,0,0,216,0,
214,214,214,214,0,214,214,214,214,214,0,
0,0,0,231,0,231,231,0,0,0,0,
0,228,0,228,0,228,228,228,0,228,228,
0,151,151,151,0,0,0,151,0,151,0,
207,207,207,207,207,207,0,207,0,207,0,
0,205,0,0,0,0,0,205,0,205,0,
0,204,0,204,204,204,204,204,0,204,204,
0,219,0,0,0,0,0,0,0,219,0,
0,217,217,217,217,217,217,217,217,217,0,
144,144,144,144,144,144,144,144,144,144,0,
0,199,199,199,0,199,199,199,199,199,199,
0,0,198,198,0,198,0,0,0,0,0,
0,196,0,0,0,196,0,0,0,0,0,
140,140,140,140,140,140,140,0,140,140,140,
0,210,0,210,210,0,0,210,0,0,0,
208,208,0,208,208,208,0,208,0,208,208,
0,190,0,0,0,190,0,190,0,0,0,
0,189,189,189,0,189,0,189,189,189,189,
125,125,0,125,125,125,125,125,125,125,125,
204,204,0,204,0,204,0,204,204,204,0,
0,0,0,134,0,0,0,134,134,134,0,
133,133,0,133,133,133,133,133,0,133,133,
0,122,0,122,122,0,0,0,0,122,0,
0,121,0,121,121,121,121,121,0,121,0,
0,180,0,0,0,0,0,0,0,180,0,
0,163,163,163,163,163,163,163,0,163,0,
0,0,0,108,0,0,0,108,108,108,0,
108,108,0,108,0,108,0,108,108,108,0,
0,97,0,0,0,97,0,0,0,0,0,
0,96,96,96,96,96,96,96,96,96,96,
95,95,95,95,0,95,95,95,95,95,95,
0,94,0,0,0,94,0,94,94,0,0,
0,139,0,139,139,139,0,139,139,139,139,
0,92,0,92,92,92,0,0,0,0,0,
136,136,0,136,0,136,136,136,136,136,136,
0,0,0,0,0,0,0,0,0,0,0,
0,0,0,0,0,0,0,0,0,0,0,
0,0,0,0,0,0,0,0,0,0,0,
0,0,0,0,0,0,0,0,0,0,0.