[layer]
type=Tile Layer 1
data=
1,0,0,0,1,21,1,0,0,0,0,
1,24,0,0,1,21,1,0,0,0,0,
1,1,1,1,1,0,1,1,1,1,1,
1,0,1,0,0,0,1,21,1,0,0,
1,0,1,0,0,0,1,21,1,0,0,
0,0,1,1,1,1,1,21,1,1,0,
0,0,1,21,16,0,0,0,1,0,0,
17,1,1,21,17,0,0,0,1,0,0,
16,0,0,21,1,1,1,1,1,0,0,
0,0,0,0,0,0,0,0,0,0,0,
0,0,0,0,0,0,0,0,0,0,0,
0,0,0,0,0,0,0,0,0,0,0,
0,0,0,0,0,0,0,0,0,0,0.
[layer]
type=Tile Layer 2
data=
71,0,0,0,71,0,71,0,0,0,0,
105,0,0,0,105,0,105,0,0,0,0,
49,49,49,49,49,0,49,49,49,49,49,
62,0,62,0,0,0,62,0,62,0,0,
61,0,61,0,0,0,61,0,61,0,0,
0,0,60,60,60,60,60,0,60,60,0,
0,0,59,0,29,0,0,0,59,0,0,
29,58,58,0,29,0,0,0,58,0,0,
28,0,0,0,57,57,57,57,57,0,0,
0,0,0,0,0,0,0,0,0,0,0,
0,0,0,0,0,0,0,0,0,0,0,
0,0,0,0,0,0,0,0,0,0,0,
0,0,0,0,0,0,0,0,0,0,0.