[layer]
type=Tile Layer 1
data=
1,0,0,0,21,1,1,1,0,0,1,
0,21,17,0,1,17,1,0,0,0,1,
16,16,16,1,1,1,1,0,21,0,1,
0,21,0,0,0,1,1,0,1,0,0,
1,16,0,0,0,16,1,1,0,0,0,
0,17,0,21,0,0,0,0,1,17,1,
0,16,1,21,0,0,24,0,16,1,0,
0,0,21,1,1,0,0,0,1,1,1,
21,1,0,0,1,7,0,1,1,16,0,
1,1,1,0,1,1,1,1,1,1,1,
0,0,0,1,1,1,1,1,1,1,21,
21,0,1,0,1,1,1,0,1,1,0,
0,0,0,0,0,1,0,1,0,21,1,
0,1,0,1,21,0,1,0,1,0,0,
1,0,0,8,0,21,1,0,1,1,0,
1,1,0,1,0,0,0,0,0,0,1,
1,1,1,1,1,1,0,1,1,1,1,
1,1,1,21,0,0,1,0,1,0,1,
1,0,0,1,0,1,1,21,0,1,1,
0,0,0,0,0,0,0,0,0,0,0,
0,0,0,0,0,0,0,0,0,0,0,
0,0,0,0,0,0,0,0,0,0,0,
0,0,0,0,0,0,0,0,0,0,0.
[layer]
type=Tile Layer 2
data=
86,0,0,0,0,86,86,86,0,0,86,
0,0,42,0,85,42,85,0,0,0,85,
37,37,37,75,75,75,75,0,0,0,75,
0,0,0,0,0,90,90,0,90,0,0,
89,44,0,0,0,44,89,89,0,0,0,
0,44,0,0,0,0,0,0,89,44,89,
0,60,121,0,0,0,0,0,60,121,0,
0,0,0,79,79,0,0,0,79,79,79,
0,117,0,0,117,0,0,117,117,58,0,
50,50,50,0,50,50,50,50,50,50,50,
0,0,0,71,71,71,71,71,71,71,0,
0,0,70,0,70,70,70,0,70,70,0,
0,0,0,0,0,62,0,62,0,0,62,
0,61,0,61,0,0,61,0,61,0,0,
90,0,0,0,0,0,90,0,90,90,0,
59,59,0,59,0,0,0,0,0,0,59,
42,42,42,42,42,42,0,42,42,42,42,
59,59,59,0,0,0,59,0,59,0,59,
58,0,0,58,0,58,58,0,0,58,58,
0,0,0,0,0,0,0,0,0,0,0,
0,0,0,0,0,0,0,0,0,0,0,
0,0,0,0,0,0,0,0,0,0,0,
0,0,0,0,0,0,0,0,0,0,0.