[layer]
type=Tile Layer 1
data=
0,0,0,1,1,21,0,0,0,3,0,
1,1,0,4,1,1,1,1,7,6,0,
0,0,0,1,0,0,0,0,21,3,0,
1,1,1,4,0,5,1,1,0,3,1,
0,0,0,1,0,6,1,0,21,0,0,
6,1,0,1,21,1,1,6,1,3,1,
0,1,8,5,0,21,0,0,0,1,0,
1,1,1,1,5,4,1,1,1,3,0,
0,21,0,1,0,0,0,6,0,1,0,
1,4,1,0,1,6,1,1,1,1,1,
0,5,0,0,0,1,0,0,21,1,0,
3,1,21,1,1,1,5,1,5,1,0,
21,4,1,6,0,1,6,1,1,1,1,
0,3,0,0,21,1,1,0,0,0,0,
1,5,21,1,1,1,3,5,1,1,1,
0,0,0,0,0,0,0,0,0,0,0,
0,0,0,0,0,0,0,0,0,0,0,
0,0,0,0,0,0,0,0,0,0,0,
0,0,0,0,0,0,0,0,0,0,0.
[layer]
type=Tile Layer 2
data=
0,0,0,75,75,0,0,0,0,75,0,
99,99,0,99,99,99,99,99,0,99,0,
0,0,0,68,0,0,0,0,0,68,0,
53,53,53,53,0,53,53,53,0,53,53,
0,0,0,66,0,66,66,0,0,0,0,
48,48,0,48,0,48,48,48,48,48,48,
0,88,0,88,0,0,0,0,0,88,0,
41,41,41,41,41,41,41,41,41,41,0,
0,0,0,52,0,0,0,52,0,52,0,
36,36,36,0,36,36,36,36,36,36,36,
0,51,0,0,0,51,0,0,0,51,0,
40,40,0,40,40,40,40,40,40,40,0,
0,39,39,39,0,39,39,39,39,39,39,
0,48,0,0,0,48,48,0,0,0,0,
33,33,0,33,33,33,33,33,33,33,33,
0,0,0,0,0,0,0,0,0,0,0,
0,0,0,0,0,0,0,0,0,0,0,
0,0,0,0,0,0,0,0,0,0,0,
0,0,0,0,0,0,0,0,0,0,0.