[layer]
type=Tile Layer 1
data=
0,1,1,1,1,1,1,1,1,1,1,
1,1,0,1,0,1,1,1,1,1,0,
0,21,0,1,0,0,0,0,0,1,0,
0,1,21,1,1,1,1,1,0,1,1,
0,1,0,1,1,0,0,1,0,0,0,
1,1,1,1,0,1,1,1,1,1,1,
0,1,0,0,0,1,0,0,21,1,0,
1,1,1,1,0,1,0,1,21,1,1,
21,0,0,0,0,1,1,1,0,0,0,
1,1,1,1,1,1,1,1,21,1,0,
21,1,0,0,0,0,0,0,0,1,0,
21,1,0,1,1,1,1,1,1,1,0,
0,0,0,1,21,0,0,1,1,0,0,
1,1,1,1,21,1,0,1,1,1,1,
1,1,1,1,1,1,1,1,1,1,21,
0,1,1,1,1,1,1,1,21,1,1,
0,0,0,0,0,1,1,1,0,0,21,
0,0,0,0,0,0,0,0,0,0,0,
0,0,0,0,0,0,0,0,0,0,0,
0,0,0,0,0,0,0,0,0,0,0,
0,0,0,0,0,0,0,0,0,0,0.
[layer]
type=Tile Layer 2
data=
0,66,66,66,66,66,66,66,66,66,66,
90,90,0,90,0,90,90,90,90,90,0,
0,0,0,90,0,0,0,0,0,90,0,
0,89,0,89,89,89,89,89,0,89,89,
0,81,0,81,81,0,0,81,0,0,0,
64,64,64,64,0,64,64,64,64,64,64,
0,81,0,0,0,81,0,0,0,81,0,
73,73,73,73,0,73,0,73,0,73,73,
0,0,0,0,0,72,72,72,0,0,0,
64,64,64,64,64,64,64,64,0,64,0,
0,63,0,0,0,0,0,0,0,63,0,
0,62,0,62,62,62,62,62,62,62,0,
0,0,0,61,0,0,0,61,61,0,0,
54,54,54,54,0,54,0,54,54,54,54,
48,48,48,48,48,48,48,48,48,48,0,
0,52,52,52,52,52,52,52,0,52,52,
0,0,0,0,0,57,57,57,0,0,0,
0,0,0,0,0,0,0,0,0,0,0,
0,0,0,0,0,0,0,0,0,0,0,
0,0,0,0,0,0,0,0,0,0,0,
0,0,0,0,0,0,0,0,0,0,0.