[layer]
type=Tile Layer 1
data=
4,0,1,0,0,21,0,2,0,2,1,
2,0,0,0,0,0,21,0,1,1,1,
1,1,0,0,0,0,0,5,5,1,0,
1,1,1,21,0,1,6,6,0,1,1,
1,0,21,0,0,1,1,4,1,6,1,
1,6,21,0,0,1,3,0,1,1,1,
4,6,1,1,1,1,1,3,1,1,0,
5,0,0,0,0,21,1,1,0,0,0,
1,0,0,21,0,0,1,4,0,0,1,
0,0,0,1,1,0,5,6,21,0,1,
8,0,1,1,21,6,1,1,4,1,0,
0,0,0,0,0,0,0,0,0,0,0,
0,0,0,0,0,0,0,0,0,0,0,
0,0,0,0,0,0,0,0,0,0,0,
0,0,0,0,0,0,0,0,0,0,0.
[layer]
type=Tile Layer 2
data=
59,0,59,0,0,0,0,59,0,59,59,
53,0,0,0,0,0,0,0,53,53,53,
52,52,0,0,0,0,0,52,52,52,0,
47,47,47,0,0,47,47,47,0,47,47,
46,0,0,0,0,46,46,46,46,46,46,
45,45,0,0,0,45,45,0,45,45,45,
31,31,31,31,31,31,31,31,31,31,0,
44,0,0,0,0,0,44,44,0,0,0,
43,0,0,0,0,0,43,43,0,0,43,
0,0,0,42,42,0,42,42,0,0,42,
0,0,61,61,0,61,61,61,61,61,0,
0,0,0,0,0,0,0,0,0,0,0,
0,0,0,0,0,0,0,0,0,0,0,
0,0,0,0,0,0,0,0,0,0,0,
0,0,0,0,0,0,0,0,0,0,0.