[layer]
type=Tile Layer 1
data=
1,0,1,0,1,0,0,1,24,21,0,
1,21,0,1,0,0,0,0,0,0,1,
1,0,1,1,1,1,2,1,1,1,1,
1,1,1,1,1,1,1,1,1,1,0,
1,1,1,0,0,1,8,0,0,0,21,
0,2,2,0,0,0,21,0,0,0,1,
0,21,0,0,0,0,0,1,0,1,1,
21,1,1,0,2,0,0,0,2,1,1,
1,2,1,2,0,1,1,1,1,1,1,
0,2,1,1,2,1,1,1,21,0,0,
0,0,1,1,1,8,0,21,0,1,1,
1,1,0,0,0,0,1,0,1,1,0,
0,1,0,0,21,0,1,1,0,0,0,
1,1,1,0,21,0,1,1,1,0,0,
1,1,0,1,0,21,0,1,1,0,0,
0,0,0,1,21,1,0,1,0,0,0,
1,1,1,0,1,1,1,21,0,1,0,
0,0,0,0,0,0,0,0,0,0,0,
0,0,0,0,0,0,0,0,0,0,0,
0,0,0,0,0,0,0,0,0,0,0,
0,0,0,0,0,0,0,0,0,0,0.
[layer]
type=Tile Layer 2
data=
109,0,109,0,109,0,0,109,0,0,0,
78,0,0,78,0,0,0,0,0,0,78,
54,0,54,54,54,54,54,54,54,54,54,
54,54,54,54,54,54,54,54,54,54,0,
106,106,106,0,0,106,0,0,0,0,0,
0,70,70,0,0,0,0,0,0,0,70,
0,0,0,0,0,0,0,68,0,68,68,
0,62,62,0,62,0,0,0,62,62,62,
43,43,43,43,0,43,43,43,43,43,43,
0,61,61,61,61,61,61,61,0,0,0,
0,0,81,81,81,0,0,0,0,81,81,
53,53,0,0,0,0,53,0,53,53,0,
0,53,0,0,0,0,53,53,0,0,0,
52,52,52,0,0,0,52,52,52,0,0,
51,51,0,51,0,0,0,51,51,0,0,
0,0,0,50,0,50,0,50,0,0,0,
49,49,49,0,49,49,49,0,0,49,0,
0,0,0,0,0,0,0,0,0,0,0,
0,0,0,0,0,0,0,0,0,0,0,
0,0,0,0,0,0,0,0,0,0,0,
0,0,0,0,0,0,0,0,0,0,0.