[layer]
type=Tile Layer 1
data=
2,1,2,18,0,16,16,16,1,2,1,
1,2,1,24,1,2,2,1,2,1,1,
0,0,0,0,18,1,16,21,1,2,1,
1,2,19,17,2,17,17,21,19,2,1,
18,18,18,0,18,0,0,0,24,0,0,
17,17,17,1,0,1,17,1,1,17,1,
16,0,0,0,0,0,16,0,16,0,1,
2,0,1,2,2,1,1,0,2,21,1,
2,0,18,18,18,16,1,0,1,7,21,
17,0,1,17,2,19,19,21,2,0,1,
18,24,2,18,16,1,1,21,18,0,1,
17,21,17,17,2,19,2,0,2,7,1,
2,21,2,1,1,2,1,7,2,1,1,
2,17,2,17,19,17,2,19,1,21,1,
21,0,0,0,7,0,18,2,16,0,1,
1,2,17,19,19,0,2,17,19,21,1,
1,1,1,1,1,0,0,0,0,0,21,
17,8,1,17,1,0,1,17,1,17,1,
18,0,18,18,18,7,1,0,0,0,0,
2,0,2,2,2,21,1,24,0,0,1,
18,21,18,16,2,0,18,0,0,0,1,
17,21,17,1,17,17,1,0,0,0,1,
0,24,0,2,18,16,1,1,0,0,21,
0,0,0,1,1,1,1,1,8,21,0,
0,21,0,1,1,2,2,1,0,0,0,
2,19,19,1,1,19,1,1,0,17,1,
21,0,0,0,0,0,0,16,16,1,1,
19,19,2,2,21,7,0,19,17,17,1,
1,1,1,1,21,24,0,1,1,1,1,
2,1,19,19,1,17,21,17,2,19,1,
2,2,1,1,0,2,2,1,21,2,1,
17,19,2,19,24,0,0,0,21,19,0,
1,1,1,1,1,1,1,1,21,1,0,
0,0,0,21,0,1,1,1,0,1,0,
1,2,2,1,0,2,1,1,21,2,0,
21,2,2,2,0,2,0,0,0,1,0,
0,1,1,1,21,1,1,1,1,1,0,
0,1,1,1,7,0,21,0,0,1,0,
1,1,1,1,1,1,1,1,21,1,0,
0,21,0,0,0,1,1,1,0,1,0,
1,1,1,1,1,1,1,1,0,1,21,
0,0,0,0,0,1,1,1,21,1,0,
0,0,0,21,0,1,1,1,0,1,0,
21,1,1,1,0,1,1,1,0,1,1,
2,16,18,18,2,16,1,1,2,0,1,
21,1,1,1,0,1,1,1,1,1,1,
18,2,0,16,2,18,21,16,1,1,0,
0,21,0,17,1,1,0,17,1,1,0,
16,16,18,1,2,2,18,16,2,0,1,
0,17,17,17,17,1,0,0,8,21,0,
0,2,2,2,2,1,21,0,0,0,0,
0,1,1,1,1,1,1,1,21,0,0,
0,2,1,2,0,1,2,2,8,21,0,
21,17,17,17,0,0,0,17,0,0,0,
21,16,16,1,0,16,1,1,0,16,1,
0,0,0,1,0,1,17,1,0,17,0,
16,1,1,16,21,1,16,16,0,16,1,
0,1,1,1,21,1,1,1,0,1,1,
1,2,2,2,2,1,2,0,1,1,1,
1,1,1,1,24,1,1,1,21,1,1,
0,0,21,1,0,1,1,1,0,0,0,
0,0,0,0,0,0,0,0,0,0,0,
0,0,0,0,0,0,0,0,0,0,0,
0,0,0,0,0,0,0,0,0,0,0,
0,0,0,0,0,0,0,0,0,0,0.
[layer]
type=Tile Layer 2
data=
110,110,110,110,0,55,55,55,110,110,110,
165,165,165,0,165,165,165,165,165,165,165,
0,0,0,0,156,156,78,0,156,156,156,
119,119,119,59,119,59,59,0,119,119,119,
252,252,252,0,252,0,0,0,0,0,0,
59,59,59,118,0,118,59,118,118,59,118,
77,0,0,0,0,0,77,0,77,0,154,
139,0,139,139,139,139,139,0,139,0,139,
229,0,229,229,229,114,229,0,229,0,0,
74,0,149,74,149,149,149,0,149,0,149,
222,0,222,222,111,222,222,0,222,0,222,
109,0,109,109,219,219,219,0,219,0,219,
178,0,178,178,178,178,178,0,178,178,178,
104,52,104,52,104,52,104,104,104,0,104,
0,0,0,0,0,0,220,220,110,0,220,
127,127,63,127,127,0,127,63,127,0,127,
157,157,157,157,157,0,0,0,0,0,0,
93,0,187,93,187,0,187,93,187,93,187,
214,0,214,214,214,0,214,0,0,0,0,
214,0,214,214,214,0,214,0,0,0,214,
142,0,142,71,142,0,142,0,0,0,142,
77,0,77,154,77,77,154,0,0,0,154,
0,0,0,228,228,114,228,228,0,0,0,
0,0,0,226,226,226,226,226,0,0,0,
0,0,0,138,138,138,138,138,0,0,0,
96,96,96,96,96,96,96,96,0,48,96,
0,0,0,0,0,0,0,68,68,137,137,
199,199,199,199,0,0,0,199,99,99,199,
198,198,198,198,0,0,0,198,198,198,198,
102,102,102,102,102,51,0,51,102,102,102,
106,106,106,106,0,106,106,106,0,106,106,
98,196,196,196,0,0,0,0,0,196,0,
105,105,105,105,105,105,105,105,0,105,0,
0,0,0,0,0,140,140,140,0,140,0,
125,125,125,125,0,125,125,125,0,125,0,
0,138,138,138,0,138,0,0,0,138,0,
0,112,112,112,0,112,112,112,112,112,0,
0,187,187,187,0,0,0,0,0,187,0,
99,99,99,99,99,99,99,99,0,99,0,
0,0,0,0,0,133,133,133,0,133,0,
106,106,106,106,106,106,106,106,0,106,0,
0,0,0,0,0,131,131,131,0,131,0,
0,0,0,0,0,119,119,119,0,119,0,
0,106,106,106,0,106,106,106,0,106,106,
83,41,83,83,83,41,83,83,83,0,83,
0,102,102,102,0,102,102,102,102,102,102,
113,113,0,56,113,113,0,56,113,113,0,
0,0,0,62,125,125,0,62,125,125,0,
40,40,81,81,81,81,81,40,81,0,81,
0,85,85,85,85,171,0,0,0,0,0,
0,112,112,112,112,112,0,0,0,0,0,
0,102,102,102,102,102,102,102,0,0,0,
0,151,151,151,0,151,151,151,0,0,0,
0,50,50,50,0,0,0,50,0,0,0,
0,40,40,80,0,40,80,80,0,40,80,
0,0,0,88,0,88,44,88,0,44,0,
35,71,71,35,0,71,35,35,0,35,71,
0,78,78,78,0,78,78,78,0,78,78,
61,61,61,61,61,61,61,0,61,61,61,
103,103,103,103,0,103,103,103,0,103,103,
0,0,0,85,0,85,85,85,0,0,0,
0,0,0,0,0,0,0,0,0,0,0,
0,0,0,0,0,0,0,0,0,0,0,
0,0,0,0,0,0,0,0,0,0,0,
0,0,0,0,0,0,0,0,0,0,0.