[layer]
type=Tile Layer 1
data=
1,1,1,1,1,0,1,21,1,0,1,
0,0,0,0,1,0,1,0,0,21,0,
1,1,1,21,1,0,1,0,1,1,1,
0,21,0,0,1,0,1,0,0,1,1,
1,1,1,21,1,0,1,1,1,1,1,
1,1,1,0,1,0,0,0,21,0,0,
1,0,1,0,1,1,1,1,1,1,1,
0,0,1,0,0,0,1,21,0,0,0,
1,1,0,1,1,1,1,1,1,1,1,
0,0,0,0,0,0,1,0,1,21,0,
1,1,1,1,1,1,1,21,1,0,1,
0,0,0,0,0,0,0,0,0,0,0,
0,0,0,0,0,0,0,0,0,0,0,
0,0,0,0,0,0,0,0,0,0,0,
0,0,0,0,0,0,0,0,0,0,0.
[layer]
type=Tile Layer 2
data=
56,56,56,56,56,0,56,0,56,0,56,
0,0,0,0,56,0,56,0,0,0,0,
49,49,49,0,49,0,49,0,49,49,49,
0,0,0,0,54,0,54,0,0,54,54,
37,37,37,0,37,0,37,37,37,37,37,
46,46,46,0,46,0,0,0,0,0,0,
37,0,37,0,37,37,37,37,37,37,37,
0,0,46,0,0,0,46,0,0,0,0,
31,31,0,31,31,31,31,31,31,31,31,
0,0,0,0,0,0,45,0,45,0,0,
35,35,35,35,35,35,35,0,35,0,35,
0,0,0,0,0,0,0,0,0,0,0,
0,0,0,0,0,0,0,0,0,0,0,
0,0,0,0,0,0,0,0,0,0,0,
0,0,0,0,0,0,0,0,0,0,0.