[layer]
type=Tile Layer 1
data=
0,3,16,5,1,1,1,16,21,0,0,
1,17,1,4,4,1,4,17,1,21,7,
1,1,1,21,0,0,4,3,1,1,0,
4,1,21,0,24,0,0,6,1,1,0,
1,21,0,5,1,0,0,1,1,5,1,
5,21,0,1,0,1,0,0,0,3,1,
16,21,16,0,0,1,0,0,24,0,1,
0,21,1,1,3,6,0,0,0,0,1,
0,0,1,5,6,1,0,0,0,21,1,
0,0,6,1,17,5,0,0,21,17,1,
0,0,4,0,0,1,0,21,1,6,1,
0,0,0,6,0,1,21,1,4,17,1,
21,0,0,1,4,0,0,3,0,1,0,
1,21,0,0,0,7,1,0,0,4,0,
4,16,21,0,0,0,0,0,1,6,0,
0,5,17,21,0,0,0,1,5,0,0,
0,0,0,1,4,1,1,0,0,0,0,
0,0,0,0,0,0,0,0,0,0,0,
0,0,0,0,0,0,0,0,0,0,0,
0,0,0,0,0,0,0,0,0,0,0,
0,0,0,0,0,0,0,0,0,0,0.
[layer]
type=Tile Layer 2
data=
0,112,56,112,112,112,112,56,0,0,0,
181,90,181,181,181,181,181,90,181,0,0,
119,119,119,0,0,0,119,119,119,119,0,
177,177,0,0,0,0,0,177,177,177,0,
108,0,0,108,108,0,0,108,108,108,108,
107,0,0,107,0,107,0,0,0,107,107,
79,0,79,0,0,159,0,0,0,0,159,
0,0,96,96,96,96,0,0,0,0,96,
0,0,95,95,95,95,0,0,0,0,95,
0,0,94,94,47,94,0,0,0,47,94,
0,0,84,0,0,84,0,0,84,84,84,
0,0,0,83,0,83,0,83,83,41,83,
0,0,0,82,82,0,0,82,0,82,0,
121,0,0,0,0,0,121,0,0,121,0,
80,40,0,0,0,0,0,0,80,80,0,
0,79,39,0,0,0,0,79,79,0,0,
0,0,0,79,79,79,79,0,0,0,0,
0,0,0,0,0,0,0,0,0,0,0,
0,0,0,0,0,0,0,0,0,0,0,
0,0,0,0,0,0,0,0,0,0,0,
0,0,0,0,0,0,0,0,0,0,0.