[layer]
type=Tile Layer 1
data=
1,0,0,0,1,21,8,0,0,0,0,
1,1,1,1,1,21,0,0,24,0,0,
1,1,1,1,1,21,0,0,0,0,0,
0,1,1,1,21,0,0,0,1,1,0,
0,0,1,21,0,0,0,16,0,0,1,
0,17,1,17,21,0,0,0,0,0,1,
0,1,1,1,1,21,0,0,0,0,1,
21,1,1,1,1,1,1,1,1,7,1,
21,1,16,16,1,1,1,1,1,1,0,
0,0,0,0,0,0,0,0,0,0,0,
0,0,0,0,0,0,0,0,0,0,0,
0,0,0,0,0,0,0,0,0,0,0,
0,0,0,0,0,0,0,0,0,0,0.
[layer]
type=Tile Layer 2
data=
111,0,0,0,111,0,0,0,0,0,0,
109,109,109,109,109,0,0,0,0,0,0,
65,65,65,65,65,0,0,0,0,0,0,
0,64,64,64,0,0,0,0,64,64,0,
0,0,63,0,0,0,0,31,0,0,63,
0,31,62,31,0,0,0,0,0,0,62,
0,61,61,61,61,0,0,0,0,0,61,
0,81,81,81,81,81,81,81,81,0,81,
0,53,26,26,53,53,53,53,53,53,0,
0,0,0,0,0,0,0,0,0,0,0,
0,0,0,0,0,0,0,0,0,0,0,
0,0,0,0,0,0,0,0,0,0,0,
0,0,0,0,0,0,0,0,0,0,0.