[layer]
type=Tile Layer 1
data=
0,0,1,1,1,1,1,1,1,0,0,
0,1,21,1,1,1,1,1,21,1,0,
1,1,1,1,1,1,1,0,1,1,1,
1,0,1,1,1,1,1,1,1,1,1,
1,1,1,1,1,1,1,1,1,1,0,
1,1,1,1,1,1,1,1,1,0,1,
1,1,1,1,1,1,1,1,0,1,1,
5,0,1,1,1,1,1,1,1,1,6,
0,5,21,1,1,1,1,1,21,6,0,
0,0,5,1,1,1,1,1,6,0,0,
0,0,0,1,1,1,1,1,0,0,0,
0,0,0,1,0,0,0,1,0,0,0,
0,0,0,1,0,21,0,1,0,0,0,
0,0,0,1,21,22,21,1,0,0,0,
0,0,0,1,23,23,23,1,0,0,0,
0,0,1,1,1,1,1,1,1,0,0,
0,0,0,1,1,1,1,1,0,0,0,
0,0,0,0,0,0,0,0,0,0,0,
0,0,0,0,0,0,0,0,0,0,0,
0,0,0,0,0,0,0,0,0,0,0,
0,0,0,0,0,0,0,0,0,0,0.
[layer]
type=Tile Layer 2
data=
0,0,108,108,108,108,108,108,108,0,0,
0,117,0,117,117,117,117,117,0,117,0,
104,104,104,104,104,104,104,0,104,104,104,
104,0,104,104,104,104,104,104,104,104,104,
96,96,96,96,96,96,96,96,96,96,0,
96,96,96,96,96,96,96,96,96,0,96,
96,96,96,96,96,96,96,96,0,96,96,
88,0,88,88,88,88,88,88,88,88,88,
0,97,0,97,97,97,97,97,0,97,0,
0,0,95,95,95,95,95,95,95,0,0,
0,0,0,86,86,86,86,86,0,0,0,
0,0,0,86,0,0,0,86,0,0,0,
0,0,0,86,0,0,0,86,0,0,0,
0,0,0,85,0,0,0,85,0,0,0,
0,0,0,82,0,0,0,82,0,0,0,
0,0,80,80,80,80,80,80,80,0,0,
0,0,0,80,80,80,80,80,0,0,0,
0,0,0,0,0,0,0,0,0,0,0,
0,0,0,0,0,0,0,0,0,0,0,
0,0,0,0,0,0,0,0,0,0,0,
0,0,0,0,0,0,0,0,0,0,0.