[layer]
type=Tile Layer 1
data=
0,0,7,0,1,1,1,1,1,1,21,
0,0,1,1,1,1,1,1,1,21,0,
0,1,16,16,1,1,1,1,21,0,0,
0,1,1,1,1,1,1,1,21,0,0,
1,1,1,1,1,1,1,1,1,7,0,
1,1,17,1,1,21,1,1,17,1,0,
0,0,1,1,0,21,1,1,1,1,1,
0,0,0,0,21,1,1,17,1,1,1,
0,1,21,21,1,1,1,1,0,1,0,
0,0,0,0,0,0,0,0,0,0,0,
0,0,0,0,0,0,0,0,0,0,0,
0,0,0,0,0,0,0,0,0,0,0,
0,0,0,0,0,0,0,0,0,0,0.
[layer]
type=Tile Layer 2
data=
0,0,0,0,127,127,127,127,127,127,0,
0,0,84,84,84,84,84,84,84,0,0,
0,75,37,37,75,75,75,75,0,0,0,
0,74,74,74,74,74,74,74,0,0,0,
109,109,109,109,109,109,109,109,109,0,0,
73,73,36,73,73,0,73,73,36,73,0,
0,0,72,72,0,0,72,72,72,72,72,
0,0,0,0,0,71,71,35,71,71,71,
0,70,0,0,70,70,70,70,0,70,0,
0,0,0,0,0,0,0,0,0,0,0,
0,0,0,0,0,0,0,0,0,0,0,
0,0,0,0,0,0,0,0,0,0,0,
0,0,0,0,0,0,0,0,0,0,0.