[layer]
type=Tile Layer 1
data=
24,17,17,2,2,19,2,1,17,19,1,
0,16,0,0,0,0,0,16,0,7,0,
0,17,24,1,3,17,0,17,0,17,0,
2,16,18,2,16,18,0,16,18,1,1,
0,1,17,17,7,1,17,17,17,1,1,
16,2,2,18,18,1,18,16,0,18,1,
5,19,17,2,19,19,1,19,0,17,1,
0,18,0,18,24,0,0,18,0,0,0,
2,1,8,2,21,17,17,19,19,19,1,
0,21,0,2,0,16,18,24,0,18,0,
0,1,21,2,0,2,2,2,7,5,0,
0,18,18,18,0,8,0,0,21,18,0,
21,17,17,17,0,17,5,17,4,1,1,
0,18,0,21,0,18,0,0,0,0,0,
21,2,24,1,1,2,0,2,6,2,1,
0,18,0,0,0,18,21,0,8,18,0,
6,1,4,1,21,6,1,1,0,1,1,
21,0,16,16,0,16,8,0,0,16,0,
21,2,2,1,6,2,24,6,2,1,0,
5,1,1,1,1,4,1,6,1,1,0,
21,2,17,17,19,1,2,19,8,19,1,
0,18,18,18,0,0,24,0,21,18,0,
2,19,2,19,0,17,19,19,21,17,1,
0,0,21,0,0,1,16,18,0,2,0,
17,17,1,17,0,1,17,17,17,1,1,
0,0,21,1,4,0,0,0,0,1,0,
2,1,21,2,2,1,2,2,5,6,1,
21,2,16,16,18,2,16,2,18,1,1,
2,1,2,1,19,17,19,17,19,6,21,
21,2,0,0,0,0,0,0,2,2,0,
0,19,21,17,19,2,0,19,1,1,1,
0,18,0,18,18,0,0,18,0,21,0,
2,2,21,19,17,17,19,1,0,19,1,
0,0,0,18,0,21,0,0,0,18,0,
17,2,21,1,0,19,2,17,2,17,0,
0,18,0,18,0,21,0,0,0,18,0,
21,17,0,1,6,17,17,17,0,1,0,
21,18,0,18,2,24,0,18,0,16,0,
17,19,0,2,17,19,0,2,21,19,1,
0,18,0,0,21,0,0,18,0,0,0,
0,17,17,1,1,17,21,17,3,17,1,
1,2,2,0,3,3,2,2,1,2,1,
17,17,1,17,17,17,1,17,1,0,1,
0,0,0,5,21,1,0,1,1,0,0,
3,1,21,1,0,1,0,1,6,1,0,
0,0,0,18,0,0,0,18,21,0,0,
1,1,4,3,1,5,1,1,21,1,1,
0,1,1,1,21,5,5,1,1,1,0,
6,1,1,1,1,6,1,1,6,0,1,
21,16,0,16,1,1,16,4,0,16,1,
1,5,1,1,0,4,21,6,1,1,1,
0,1,21,0,0,1,0,3,0,0,0,
21,4,0,1,1,1,0,1,0,4,1,
0,2,0,2,0,0,0,2,0,21,0,
3,4,0,1,21,1,1,1,1,6,1,
0,0,0,2,0,21,0,0,2,2,0,
0,6,1,1,0,3,21,1,1,1,0,
0,1,0,0,0,4,21,0,0,1,0,
17,3,21,4,17,17,17,3,0,17,1,
0,1,0,0,0,24,0,4,21,0,0,
3,1,1,1,4,1,21,4,1,1,1,
2,1,1,1,2,0,2,2,2,2,1,
0,2,0,2,0,2,21,2,0,1,1,
21,18,0,18,0,0,0,18,0,0,0,
2,2,1,2,2,2,1,0,1,2,1,
0,0,0,16,0,0,16,16,0,21,0,
0,1,17,17,1,3,17,17,1,17,1,
0,0,0,1,0,0,0,21,0,3,0,
1,1,0,1,21,1,1,1,4,4,0,
0,1,0,21,0,0,0,8,4,1,0,
0,4,21,1,1,1,6,4,1,1,1,
0,1,1,4,0,0,0,21,0,0,0,
1,4,1,2,0,2,1,2,2,2,21,
0,21,0,0,0,2,0,0,0,2,0,
0,5,1,1,1,1,0,1,21,4,1,
0,1,1,0,0,0,0,5,0,0,21,
0,0,0,0,0,0,0,0,0,0,0,
0,0,0,0,0,0,0,0,0,0,0,
0,0,0,0,0,0,0,0,0,0,0,
0,0,0,0,0,0,0,0,0,0,0.
[layer]
type=Tile Layer 2
data=
0,151,151,303,303,303,303,303,151,303,303,
0,151,0,0,0,0,0,151,0,0,0,
0,151,0,303,303,151,0,151,0,151,0,
186,93,186,186,93,186,0,93,186,186,186,
0,279,139,139,0,279,139,139,139,279,279,
93,186,186,186,186,186,186,93,0,186,186,
202,202,101,202,202,202,202,202,0,101,202,
0,303,0,303,0,0,0,303,0,0,0,
303,303,0,303,0,151,151,303,303,303,303,
0,0,0,276,0,138,276,0,0,276,0,
0,274,0,274,0,274,274,274,0,274,0,
0,273,273,273,0,0,0,0,0,273,0,
0,98,98,98,0,98,197,98,197,197,197,
0,196,0,0,0,196,0,0,0,0,0,
0,291,0,291,291,291,0,291,291,291,291,
0,267,0,0,0,267,0,0,0,267,0,
177,177,177,177,0,177,177,177,0,177,177,
0,0,132,132,0,132,0,0,0,132,0,
0,285,285,285,285,285,0,285,285,285,0,
188,188,188,188,188,188,188,188,188,188,0,
0,282,141,141,282,282,282,282,0,282,282,
0,258,258,258,0,0,0,0,0,258,0,
171,171,171,171,0,85,171,171,0,85,171,
0,0,0,0,0,170,85,170,0,170,0,
92,92,184,92,0,184,92,92,92,184,184,
0,0,0,184,184,0,0,0,0,184,0,
182,182,0,182,182,182,182,182,182,182,182,
0,167,83,83,167,167,83,167,167,167,167,
166,166,166,166,166,83,166,83,166,166,0,
0,165,0,0,0,0,0,0,165,165,0,
0,178,0,89,178,178,0,178,178,178,178,
0,176,0,176,176,0,0,176,0,0,0,
175,175,0,175,87,87,175,175,0,175,175,
0,0,0,160,0,0,0,0,0,160,0,
79,159,0,159,0,159,159,79,159,79,0,
0,158,0,158,0,0,0,0,0,158,0,
0,85,0,170,170,85,85,85,0,170,0,
0,253,0,253,253,0,0,253,0,126,0,
84,168,0,168,84,168,0,168,0,168,168,
0,154,0,0,0,0,0,154,0,0,0,
0,76,76,153,153,76,0,76,153,76,153,
151,151,151,0,151,151,151,151,151,151,151,
82,82,164,82,82,82,164,82,164,0,164,
0,0,0,164,0,164,0,164,164,0,0,
163,163,0,163,0,163,0,163,163,163,0,
0,0,0,149,0,0,0,149,0,0,0,
148,148,148,148,148,148,148,148,0,148,148,
0,147,147,147,0,147,147,147,147,147,0,
158,158,158,158,158,158,158,158,158,0,158,
0,79,0,79,158,158,79,158,0,79,158,
157,157,157,157,0,157,0,157,157,157,157,
0,144,0,0,0,144,0,144,0,0,0,
0,143,0,143,143,143,0,143,0,143,143,
0,142,0,142,0,0,0,142,0,0,0,
152,152,0,152,0,152,152,152,152,152,152,
0,0,0,151,0,0,0,0,151,151,0,
0,150,150,150,0,150,0,150,150,150,0,
0,137,0,0,0,137,0,0,0,137,0,
68,136,0,136,68,68,68,136,0,68,136,
0,202,0,0,0,0,0,202,0,0,0,
145,145,145,145,145,145,0,145,145,145,145,
144,144,144,144,144,0,144,144,144,144,144,
0,144,0,144,0,144,0,144,0,144,144,
0,132,0,132,0,0,0,132,0,0,0,
131,131,131,131,131,131,131,0,131,131,131,
0,0,0,65,0,0,65,65,0,0,0,
0,119,59,59,119,119,59,59,119,59,119,
0,0,0,119,0,0,0,0,0,119,0,
118,118,0,118,0,118,118,118,118,118,0,
0,159,0,0,0,0,0,0,159,159,0,
0,105,0,105,105,105,105,105,105,105,105,
0,104,104,104,0,0,0,0,0,0,0,
103,103,103,103,0,103,103,103,103,103,0,
0,0,0,0,0,102,0,0,0,102,0,
0,101,101,101,101,101,0,101,0,101,101,
0,100,100,0,0,0,0,100,0,0,0,
0,0,0,0,0,0,0,0,0,0,0,
0,0,0,0,0,0,0,0,0,0,0,
0,0,0,0,0,0,0,0,0,0,0,
0,0,0,0,0,0,0,0,0,0,0.