[layer]
type=Tile Layer 1
data=
6,1,3,1,0,0,0,21,0,4,0,
4,1,4,1,0,0,21,0,4,0,6,
5,1,1,3,21,0,0,4,0,6,4,
3,6,1,1,0,0,4,0,6,4,21,
1,3,5,1,0,4,0,6,4,21,6,
0,3,0,0,0,0,21,4,1,6,1,
5,0,3,0,21,0,0,5,1,4,1,
3,5,0,3,21,0,0,5,1,6,1,
0,3,5,21,3,0,0,1,4,6,1,
5,0,3,5,21,3,0,5,1,3,1,
1,1,5,3,0,0,0,0,21,4,0,
1,4,1,6,0,0,21,0,4,0,6,
3,6,1,1,21,0,0,4,0,6,4,
1,6,5,1,0,0,4,21,6,4,0,
1,1,5,6,0,4,0,6,4,21,6,
0,3,21,0,0,0,0,6,5,1,1,
5,0,3,0,21,0,0,5,1,3,1,
3,5,21,3,0,0,0,3,1,5,1,
0,3,5,0,3,0,21,1,3,6,1,
21,0,0,0,0,0,0,0,0,0,0,
0,0,0,0,0,0,0,0,0,0,0,
0,0,0,0,0,0,0,0,0,0,0,
0,0,0,0,0,0,0,0,0,0,0.
[layer]
type=Tile Layer 2
data=
92,92,92,92,0,0,0,0,0,92,0,
90,90,90,90,0,0,0,0,90,0,90,
89,89,89,89,0,0,0,89,0,89,89,
96,96,96,96,0,0,96,0,96,96,0,
95,95,95,95,0,95,0,95,95,0,95,
0,94,0,0,0,0,0,94,94,94,94,
85,0,85,0,0,0,0,85,85,85,85,
84,84,0,84,0,0,0,84,84,84,84,
0,83,83,0,83,0,0,83,83,83,83,
75,0,75,75,0,75,0,75,75,75,75,
74,74,74,74,0,0,0,0,0,74,0,
73,73,73,73,0,0,0,0,73,0,73,
65,65,65,65,0,0,0,65,0,65,65,
64,64,64,64,0,0,64,0,64,64,0,
63,63,63,63,0,63,0,63,63,0,63,
0,62,0,0,0,0,0,62,62,62,62,
61,0,61,0,0,0,0,61,61,61,61,
60,60,0,60,0,0,0,60,60,60,60,
0,59,59,0,59,0,0,59,59,59,59,
0,0,0,0,0,0,0,0,0,0,0,
0,0,0,0,0,0,0,0,0,0,0,
0,0,0,0,0,0,0,0,0,0,0,
0,0,0,0,0,0,0,0,0,0,0.