[layer]
type=Tile Layer 1
data=
0,1,2,2,2,2,1,1,24,3,1,
0,2,0,2,2,3,1,2,7,1,1,
5,1,1,1,0,1,5,1,1,5,1,
8,2,1,1,1,1,2,2,0,2,0,
21,24,0,1,2,6,1,2,0,1,0,
1,2,0,5,2,2,1,1,0,2,0,
1,1,0,1,1,3,2,2,2,2,1,
0,2,1,3,2,1,6,1,2,2,1,
24,2,21,1,3,1,2,2,0,0,0,
2,2,0,1,2,1,4,2,21,1,1,
24,0,0,1,1,1,1,2,0,2,21,
1,2,2,0,1,2,1,1,1,2,1,
4,1,0,0,0,1,21,0,0,1,0,
1,4,21,1,1,1,24,3,1,1,0,
2,2,7,2,0,21,0,2,0,0,0,
2,1,0,2,0,7,0,2,1,2,21,
8,2,2,6,21,2,1,1,0,2,0,
6,1,1,1,1,5,21,1,3,1,24,
2,1,3,1,1,2,2,1,2,8,0,
21,0,0,0,1,2,1,2,3,0,0,
4,1,2,2,2,0,2,1,2,1,1,
1,2,2,21,2,1,1,1,2,24,1,
1,24,2,1,5,21,2,2,2,0,1,
1,0,1,2,2,0,2,24,2,21,0,
1,2,2,1,2,21,2,0,6,2,1,
0,21,2,2,2,0,2,0,0,0,1,
0,21,2,3,2,24,1,2,2,0,1,
0,0,0,0,1,7,2,6,2,21,1,
2,21,5,2,1,2,1,2,4,6,1,
3,21,1,6,1,7,1,1,1,0,0,
1,0,4,1,1,0,1,6,1,21,0,
1,1,4,1,6,21,1,1,4,1,1,
5,0,5,1,4,1,1,1,1,1,1,
1,1,3,21,2,5,2,2,2,1,1,
2,2,2,0,0,21,0,0,0,24,2,
4,1,1,21,0,0,0,0,3,1,1,
5,6,1,21,0,0,0,0,1,1,1,
2,2,2,0,0,21,0,0,1,2,1,
2,0,1,2,4,21,8,0,2,2,1,
1,21,1,6,1,0,0,0,0,0,0,
1,3,1,1,1,6,4,1,1,21,1,
0,0,2,2,2,0,0,0,2,21,1,
1,0,5,1,1,0,0,21,1,6,1,
5,24,1,5,1,1,1,1,1,21,0,
0,0,1,0,0,0,1,1,6,0,21,
4,1,1,1,3,21,1,4,1,0,1,
1,1,1,4,4,0,5,1,1,21,1,
2,3,2,2,2,21,0,0,0,0,0,
3,1,1,1,1,21,3,5,1,1,1,
0,0,0,0,3,0,3,1,1,21,1,
1,1,1,0,5,0,1,6,1,21,1,
2,2,1,0,2,0,1,1,2,0,21,
1,1,1,21,4,0,3,1,1,0,1,
1,0,1,21,1,6,1,5,3,1,1,
2,0,1,21,2,2,1,0,2,1,1,
1,0,1,21,4,1,1,0,1,5,1,
6,21,1,4,1,3,1,1,1,8,1,
2,0,1,0,1,2,1,2,2,21,1,
2,21,5,1,2,2,2,1,1,0,1,
21,0,0,24,4,3,1,2,2,0,0,
1,1,1,21,1,5,1,3,4,24,1,
1,1,3,21,0,0,0,0,0,0,1,
1,1,1,6,5,1,1,21,6,1,1,
4,2,2,0,21,0,2,0,2,0,1,
1,1,1,0,1,5,5,0,1,21,1,
1,2,6,2,2,21,1,6,2,2,1,
0,0,21,0,0,0,1,0,1,6,1,
1,1,1,21,6,1,4,0,3,1,1,
1,0,3,1,1,1,1,1,1,6,1,
1,1,3,0,5,21,0,0,0,0,1,
1,1,4,21,6,0,1,1,1,0,1,
0,0,0,0,0,0,0,0,0,0,0,
0,0,0,0,0,0,0,0,0,0,0,
0,0,0,0,0,0,0,0,0,0,0,
0,0,0,0,0,0,0,0,0,0,0.
[layer]
type=Tile Layer 2
data=
0,214,214,214,214,214,214,214,0,214,214,
0,262,0,262,262,262,262,262,0,262,262,
137,137,137,137,0,137,137,137,137,137,137,
0,262,262,262,262,262,262,262,0,262,0,
0,0,0,267,267,267,267,267,0,267,0,
160,160,0,160,160,160,160,160,0,160,0,
125,125,0,125,125,125,125,125,125,125,125,
0,136,136,136,136,136,136,136,136,136,136,
0,289,0,289,289,289,289,289,0,0,0,
154,154,0,154,154,154,154,154,0,154,154,
0,0,0,262,262,262,262,262,0,262,0,
122,122,122,0,122,122,122,122,122,122,122,
174,174,0,0,0,174,0,0,0,174,0,
253,253,0,253,253,253,0,253,253,253,0,
280,280,0,280,0,0,0,280,0,0,0,
279,279,0,279,0,0,0,279,279,279,0,
0,255,255,255,0,255,255,255,0,255,0,
204,204,204,204,204,204,0,204,204,204,0,
201,201,201,201,201,201,201,201,201,0,0,
0,0,0,0,182,182,182,182,182,0,0,
127,127,127,127,127,0,127,127,127,127,127,
217,217,217,0,217,217,217,217,217,0,217,
223,0,223,223,223,0,223,223,223,0,223,
246,0,246,246,246,0,246,0,246,0,0,
131,131,131,131,131,0,131,0,131,131,131,
0,0,176,176,176,0,176,0,0,0,176,
0,0,262,262,262,0,262,262,262,0,262,
0,0,0,0,261,0,261,261,261,0,261,
111,0,111,111,111,111,111,111,111,111,111,
237,0,237,237,237,0,237,237,237,0,0,
156,0,156,156,156,0,156,156,156,0,0,
119,119,119,119,119,0,119,119,119,119,119,
118,0,118,118,118,118,118,118,118,118,118,
118,118,118,0,118,118,118,118,118,118,118,
229,229,229,0,0,0,0,0,0,0,229,
152,152,152,0,0,0,0,0,152,152,152,
151,151,151,0,0,0,0,0,151,151,151,
163,163,163,0,0,0,0,0,163,163,163,
243,0,243,243,243,0,0,0,243,243,243,
161,0,161,161,161,0,0,0,0,0,0,
104,104,104,104,104,104,104,104,104,0,104,
0,0,145,145,145,0,0,0,145,0,145,
144,0,144,144,144,0,0,0,144,144,144,
210,0,210,210,210,210,210,210,210,0,0,
0,0,155,0,0,0,155,155,155,0,0,
124,124,124,124,124,0,124,124,124,0,124,
112,112,112,112,112,0,112,112,112,0,112,
139,139,139,139,139,0,0,0,0,0,0,
97,97,97,97,97,0,97,97,97,97,97,
0,0,0,0,149,0,149,149,149,0,149,
133,133,133,0,133,0,133,133,133,0,133,
146,146,146,0,146,0,146,146,146,0,0,
120,120,120,0,120,0,120,120,120,0,120,
106,0,106,0,106,106,106,106,106,106,106,
118,0,118,0,118,118,118,0,118,118,118,
127,0,127,0,127,127,127,0,127,127,127,
169,0,169,169,169,169,169,169,169,0,169,
125,0,125,0,125,125,125,125,125,0,125,
101,0,101,101,101,101,101,101,101,0,101,
0,0,0,0,189,189,189,189,189,0,0,
150,150,150,0,150,150,150,150,150,0,150,
113,113,113,0,0,0,0,0,0,0,113,
79,79,79,79,79,79,79,0,79,79,79,
111,111,111,0,0,0,111,0,111,0,111,
89,89,89,0,89,89,89,0,89,0,89,
69,69,69,69,69,0,69,69,69,69,69,
0,0,0,0,0,0,97,0,97,97,97,
77,77,77,0,77,77,77,0,77,77,77,
67,0,67,67,67,67,67,67,67,67,67,
95,95,95,0,95,0,0,0,0,0,95,
85,85,85,0,85,0,85,85,85,0,85,
0,0,0,0,0,0,0,0,0,0,0,
0,0,0,0,0,0,0,0,0,0,0,
0,0,0,0,0,0,0,0,0,0,0,
0,0,0,0,0,0,0,0,0,0,0.