[layer]
type=Tile Layer 1
data=
2,0,0,24,0,0,1,0,21,0,1,
1,1,1,1,1,1,1,1,1,0,1,
1,2,1,1,1,1,1,0,2,1,1,
1,0,1,0,1,1,1,21,1,1,1,
1,0,0,21,2,0,0,0,1,0,0,
1,1,1,1,1,8,1,1,1,21,1,
0,0,0,0,2,0,1,0,0,21,1,
1,1,1,21,2,0,1,0,2,1,1,
0,0,0,0,1,21,0,0,1,0,0,
1,1,1,1,1,1,1,1,1,21,1,
8,0,21,0,0,0,2,0,0,0,1,
1,1,1,1,1,0,1,0,1,1,1,
0,0,0,0,1,21,0,0,1,0,0,
1,1,1,0,1,1,1,1,1,21,1,
0,21,0,0,1,0,0,0,1,0,0,
1,1,1,1,1,1,1,0,1,1,1,
0,0,1,1,0,21,1,0,0,0,0,
1,21,1,1,1,0,1,1,1,1,1,
0,0,1,0,0,0,1,21,0,0,1,
0,0,0,0,0,0,0,0,0,0,0,
0,0,0,0,0,0,0,0,0,0,0,
0,0,0,0,0,0,0,0,0,0,0,
0,0,0,0,0,0,0,0,0,0,0.
[layer]
type=Tile Layer 2
data=
129,0,0,0,0,0,129,0,0,0,129,
68,68,68,68,68,68,68,68,68,0,68,
68,68,68,68,68,68,68,0,68,68,68,
92,0,92,0,92,92,92,0,92,92,92,
91,0,0,0,91,0,0,0,91,0,0,
120,120,120,120,120,0,120,120,120,0,120,
0,0,0,0,82,0,82,0,0,0,82,
81,81,81,0,81,0,81,0,81,81,81,
0,0,0,0,79,0,0,0,79,0,0,
58,58,58,58,58,58,58,58,58,0,58,
0,0,0,0,0,0,106,0,0,0,106,
63,63,63,63,63,0,63,0,63,63,63,
0,0,0,0,63,0,0,0,63,0,0,
56,56,56,0,56,56,56,56,56,0,56,
0,0,0,0,61,0,0,0,61,0,0,
49,49,49,49,49,49,49,0,49,49,49,
0,0,60,60,0,0,60,0,0,0,0,
53,0,53,53,53,0,53,53,53,53,53,
0,0,58,0,0,0,58,0,0,0,58,
0,0,0,0,0,0,0,0,0,0,0,
0,0,0,0,0,0,0,0,0,0,0,
0,0,0,0,0,0,0,0,0,0,0,
0,0,0,0,0,0,0,0,0,0,0.