[layer]
type=Tile Layer 1
data=
0,4,5,0,0,0,0,0,0,0,0,
6,1,21,4,4,3,1,1,1,21,0,
1,21,4,1,0,0,0,21,3,3,21,
4,0,4,0,4,1,1,3,21,1,0,
1,0,6,0,1,0,0,3,0,1,0,
1,0,4,0,1,0,0,1,0,3,0,
1,0,5,3,0,0,1,6,21,5,0,
5,5,21,5,1,5,6,21,3,6,0,
0,5,3,21,0,0,0,5,6,0,0,
0,0,0,0,0,0,0,0,0,0,0,
0,0,0,0,0,0,0,0,0,0,0,
0,0,0,0,0,0,0,0,0,0,0,
0,0,0,0,0,0,0,0,0,0,0.
[layer]
type=Tile Layer 2
data=
0,85,85,0,0,0,0,0,0,0,0,
85,85,0,85,85,85,85,85,85,0,0,
75,0,75,75,0,0,0,0,75,75,0,
72,0,72,0,72,72,72,72,0,72,0,
71,0,71,0,71,0,0,71,0,71,0,
71,0,71,0,71,0,0,71,0,71,0,
71,0,71,71,0,0,71,71,0,71,0,
70,70,0,70,70,70,70,0,70,70,0,
0,68,68,0,0,0,0,68,68,0,0,
0,0,0,0,0,0,0,0,0,0,0,
0,0,0,0,0,0,0,0,0,0,0,
0,0,0,0,0,0,0,0,0,0,0,
0,0,0,0,0,0,0,0,0,0,0.