[layer]
type=Tile Layer 1
data=
23,0,0,0,0,0,0,1,1,1,0,
0,0,0,0,0,0,1,1,1,1,1,
1,1,2,0,0,0,1,1,23,2,1,
1,1,1,1,7,0,2,1,2,1,1,
2,23,1,1,0,0,0,1,1,2,0,
1,1,1,1,0,0,0,0,0,0,0,
1,1,1,0,0,0,0,0,0,0,0,
0,0,0,0,0,0,1,1,1,0,0,
0,0,0,0,0,1,1,1,1,1,0,
0,0,0,0,0,0,0,0,0,0,0,
0,0,0,0,0,0,0,0,0,0,0,
0,0,0,0,0,0,0,0,0,0,0,
0,0,0,0,0,0,0,0,0,0,0.
[layer]
type=Tile Layer 2
data=
0,0,0,0,0,0,0,67,67,67,0,
0,0,0,0,0,0,66,66,66,66,66,
59,59,59,0,0,0,59,59,0,59,59,
78,78,78,78,0,0,78,78,78,78,78,
58,0,58,58,0,0,0,58,58,58,0,
58,58,58,58,0,0,0,0,0,0,0,
58,58,58,0,0,0,0,0,0,0,0,
0,0,0,0,0,0,58,58,58,0,0,
0,0,0,0,0,58,58,58,58,58,0,
0,0,0,0,0,0,0,0,0,0,0,
0,0,0,0,0,0,0,0,0,0,0,
0,0,0,0,0,0,0,0,0,0,0,
0,0,0,0,0,0,0,0,0,0,0.