[layer]
type=Tile Layer 1
data=
23,0,1,1,5,3,1,0,0,0,0,
0,1,3,6,21,1,1,1,0,0,0,
1,1,4,1,5,1,4,1,1,0,23,
1,3,21,5,1,1,1,1,4,0,0,
0,1,3,1,1,4,1,1,1,0,0,
0,0,1,5,1,1,1,6,1,1,0,
0,0,0,0,1,1,3,3,1,1,0,
0,0,0,0,0,0,4,1,1,0,0,
1,1,0,0,0,0,0,3,1,0,0,
0,4,3,1,0,0,0,0,1,0,23,
0,0,3,1,1,1,1,3,0,0,0,
0,0,1,1,3,1,3,5,1,1,1,
23,0,1,4,1,1,5,1,3,0,1,
0,0,4,1,1,4,1,1,1,0,0,
0,4,1,1,4,1,1,6,1,1,0,
0,1,6,1,1,5,5,1,1,1,0,
0,1,3,1,6,1,1,1,4,1,0,
0,0,0,0,0,0,0,0,0,0,0,
0,0,0,0,0,0,0,0,0,0,0,
0,0,0,0,0,0,0,0,0,0,0,
0,0,0,0,0,0,0,0,0,0,0.
[layer]
type=Tile Layer 2
data=
0,0,102,102,102,102,102,0,0,0,0,
0,110,110,110,0,110,110,110,0,0,0,
108,108,108,108,108,108,108,108,108,0,0,
107,107,0,107,107,107,107,107,107,0,0,
0,98,98,98,98,98,98,98,98,0,0,
0,0,98,98,98,98,98,98,98,98,0,
0,0,0,0,98,98,98,98,98,98,0,
0,0,0,0,0,0,90,90,90,0,0,
90,90,0,0,0,0,0,90,90,0,0,
0,90,90,90,0,0,0,0,90,0,0,
0,0,80,80,80,80,80,80,0,0,0,
0,0,80,80,80,80,80,80,80,80,80,
0,0,80,80,80,80,80,80,80,0,80,
0,0,80,80,80,80,80,80,80,0,0,
0,80,80,80,80,80,80,80,80,80,0,
0,80,80,80,80,80,80,80,80,80,0,
0,80,80,80,80,80,80,80,80,80,0,
0,0,0,0,0,0,0,0,0,0,0,
0,0,0,0,0,0,0,0,0,0,0,
0,0,0,0,0,0,0,0,0,0,0,
0,0,0,0,0,0,0,0,0,0,0.