[layer]
type=Tile Layer 1
data=
6,0,1,0,2,7,18,18,16,18,1,
17,1,2,2,2,17,0,19,17,19,1,
16,1,1,18,18,2,16,0,2,18,1,
4,1,2,2,1,2,1,1,0,2,1,
0,24,0,0,16,4,1,2,18,0,0,
17,0,21,7,1,3,17,4,1,0,0,
18,5,18,18,16,0,6,18,1,2,1,
1,2,1,1,2,8,2,21,2,2,1,
2,1,1,1,2,7,2,21,2,2,1,
2,17,17,19,2,24,19,21,19,4,1,
2,7,16,16,18,1,18,21,2,0,1,
1,24,2,2,2,2,1,21,0,0,0,
2,21,2,18,2,16,4,16,3,16,1,
19,19,2,19,17,21,0,0,0,8,0,
1,3,3,16,16,21,16,1,16,16,1,
6,2,2,2,17,17,0,17,2,17,1,
4,0,2,1,1,21,2,1,2,2,1,
19,0,19,0,19,0,0,21,0,0,19,
16,21,18,8,2,0,16,2,16,2,1,
0,0,21,0,1,7,17,17,1,6,1,
1,4,1,1,6,21,1,1,5,1,1,
2,2,2,2,8,0,21,0,0,0,0,
0,2,18,16,1,2,18,5,18,1,1,
2,2,17,17,0,17,2,17,1,2,0,
18,1,2,18,0,16,24,18,1,1,21,
2,6,17,2,0,17,0,2,17,19,21,
1,18,18,2,18,16,0,4,0,1,21,
0,0,24,6,1,2,21,2,0,1,0,
1,16,21,16,5,5,0,16,0,16,0,
0,2,0,2,0,21,0,2,0,1,0,
0,16,1,1,1,16,16,1,21,16,0,
5,17,17,17,1,1,1,1,21,17,0,
0,1,3,1,5,1,1,1,0,1,21,
2,1,2,2,3,2,2,21,5,1,1,
5,0,16,16,1,1,5,21,16,16,1,
1,0,1,1,5,1,3,21,1,3,1,
16,0,1,18,2,2,18,0,1,16,1,
6,21,1,1,6,2,1,2,2,2,1,
3,1,1,21,5,1,3,1,1,1,1,
0,0,1,21,1,1,1,1,4,3,1,
1,16,1,16,16,21,3,16,16,1,1,
1,1,5,1,1,0,6,21,1,0,0,
16,16,1,16,1,21,16,0,16,0,1,
6,1,17,0,17,17,3,21,17,0,1,
1,5,1,0,0,0,21,0,4,0,1,
2,17,2,1,2,19,17,19,17,21,1,
2,0,0,21,0,0,2,3,2,1,1,
1,0,0,0,21,0,1,5,5,1,1,
1,1,1,3,6,21,0,0,0,0,0,
1,1,3,4,1,21,1,3,1,1,1,
0,21,0,1,1,4,3,1,1,1,1,
0,21,0,2,1,2,0,1,2,4,1,
1,1,21,5,1,1,0,3,5,1,1,
0,4,21,3,1,1,0,1,1,1,1,
18,18,1,0,18,4,16,2,1,16,1,
17,17,21,1,1,17,17,1,8,0,0,
0,16,0,5,1,16,0,16,0,21,0,
0,6,0,1,3,1,0,1,0,0,21,
0,1,0,5,1,1,0,4,24,0,0,
1,5,0,1,4,1,0,1,21,1,1,
4,4,0,1,0,21,0,1,0,1,1,
0,0,0,0,0,0,0,0,0,0,0,
0,0,0,0,0,0,0,0,0,0,0,
0,0,0,0,0,0,0,0,0,0,0,
0,0,0,0,0,0,0,0,0,0,0.
[layer]
type=Tile Layer 2
data=
211,0,211,0,211,0,211,211,105,211,211,
55,110,110,110,110,55,0,110,55,110,110,
55,110,110,110,110,110,55,0,110,110,110,
120,120,120,120,120,120,120,120,0,120,120,
0,0,0,0,127,255,255,255,255,0,0,
127,0,0,0,255,255,127,255,255,0,0,
109,109,109,109,54,0,109,109,109,109,109,
187,187,187,187,187,0,187,0,187,187,187,
184,184,184,184,184,0,184,0,184,184,184,
199,99,99,199,199,0,199,0,199,199,199,
223,0,111,111,223,223,223,0,223,0,223,
246,0,246,246,246,246,246,0,0,0,0,
106,0,106,106,106,53,106,53,106,53,106,
223,223,223,223,111,0,0,0,0,0,0,
104,104,104,52,52,0,52,104,52,52,104,
113,113,113,113,56,56,0,56,113,56,113,
128,0,128,128,128,0,128,128,128,128,128,
158,0,158,0,158,0,0,0,0,0,158,
97,0,195,0,195,0,97,195,97,195,195,
0,0,0,0,214,0,107,107,214,214,214,
100,100,100,100,100,0,100,100,100,100,100,
231,231,231,231,0,0,0,0,0,0,0,
0,107,107,53,107,107,107,107,107,107,107,
122,122,61,61,0,61,122,61,122,122,0,
189,189,189,189,0,94,0,189,189,189,0,
125,125,62,125,0,62,0,125,62,125,0,
123,123,123,123,123,61,0,123,0,123,0,
0,0,0,223,223,223,0,223,0,223,0,
148,74,0,74,148,148,0,74,0,74,0,
0,146,0,146,0,0,0,146,0,146,0,
0,60,120,120,120,60,60,120,0,60,0,
106,53,53,53,106,106,106,106,0,53,0,
0,118,118,118,118,118,118,118,0,118,0,
100,100,100,100,100,100,100,0,100,100,100,
113,0,56,56,113,113,113,0,56,56,113,
112,0,112,112,112,112,112,0,112,112,112,
50,0,101,101,101,101,101,0,101,50,101,
89,0,89,89,89,89,89,89,89,89,89,
88,88,88,0,88,88,88,88,88,88,88,
0,0,122,0,122,122,122,122,122,122,122,
95,47,95,47,47,0,95,47,47,95,95,
133,133,133,133,133,0,133,0,133,0,0,
54,54,109,54,109,0,54,0,54,0,109,
108,108,54,0,54,54,108,0,54,0,108,
119,119,119,0,0,0,0,0,119,0,119,
90,45,90,90,90,90,45,90,45,0,90,
127,0,0,0,0,0,127,127,127,127,127,
126,0,0,0,0,0,126,126,126,126,126,
115,115,115,115,115,0,0,0,0,0,0,
81,81,81,81,81,0,81,81,81,81,81,
0,0,0,101,101,101,101,101,101,101,101,
0,0,0,102,102,102,0,102,102,102,102,
81,81,0,81,81,81,0,81,81,81,81,
0,90,0,90,90,90,0,90,90,90,90,
63,63,63,0,63,63,31,63,63,31,63,
66,66,0,133,133,66,66,133,0,0,0,
0,44,0,88,88,44,0,44,0,0,0,
0,87,0,87,87,87,0,87,0,0,0,
0,129,0,129,129,129,0,129,0,0,0,
77,77,0,77,77,77,0,77,0,77,77,
85,85,0,85,0,0,0,85,0,85,85,
0,0,0,0,0,0,0,0,0,0,0,
0,0,0,0,0,0,0,0,0,0,0,
0,0,0,0,0,0,0,0,0,0,0,
0,0,0,0,0,0,0,0,0,0,0.