[layer]
type=Tile Layer 1
data=
1,0,0,0,0,0,1,1,0,0,21,
1,21,1,1,1,1,1,1,1,0,1,
1,0,1,0,0,0,0,0,21,0,1,
1,0,1,21,1,1,1,0,1,1,1,
0,0,1,0,0,0,1,21,1,1,0,
1,1,1,1,1,21,1,0,1,1,1,
0,0,0,0,1,0,1,0,0,21,0,
1,1,1,0,1,21,1,1,1,1,1,
0,1,1,0,0,21,1,1,1,0,0,
1,1,1,1,1,1,1,21,1,0,1,
1,0,1,1,1,1,1,1,1,1,1,
0,0,0,0,0,0,0,0,0,0,0,
0,0,0,0,0,0,0,0,0,0,0,
0,0,0,0,0,0,0,0,0,0,0,
0,0,0,0,0,0,0,0,0,0,0.
[layer]
type=Tile Layer 2
data=
63,0,0,0,0,0,63,63,0,0,0,
45,0,45,45,45,45,45,45,45,0,45,
56,0,56,0,0,0,0,0,0,0,56,
49,0,49,0,49,49,49,0,49,49,49,
0,0,48,0,0,0,48,0,48,48,0,
37,37,37,37,37,0,37,0,37,37,37,
0,0,0,0,46,0,46,0,0,0,0,
37,37,37,0,37,0,37,37,37,37,37,
0,45,45,0,0,0,45,45,45,0,0,
35,35,35,35,35,35,35,0,35,0,35,
30,0,30,30,30,30,30,30,30,30,30,
0,0,0,0,0,0,0,0,0,0,0,
0,0,0,0,0,0,0,0,0,0,0,
0,0,0,0,0,0,0,0,0,0,0,
0,0,0,0,0,0,0,0,0,0,0.