[layer]
type=Tile Layer 1
data=
1,1,1,1,0,1,1,1,1,1,1,
1,1,1,0,0,1,0,21,0,1,1,
1,1,1,0,1,1,1,1,0,1,1,
1,1,1,21,0,1,1,1,0,1,1,
1,1,1,0,0,1,1,1,21,1,1,
1,1,1,21,0,1,1,0,0,1,1,
1,1,1,1,21,1,1,0,1,1,1,
1,0,1,1,1,1,1,1,1,1,1,
1,1,1,0,21,0,0,1,1,1,1,
0,0,0,0,0,0,0,0,0,0,0,
0,0,0,0,0,0,0,0,0,0,0,
0,0,0,0,0,0,0,0,0,0,0,
0,0,0,0,0,0,0,0,0,0,0.
[layer]
type=Tile Layer 2
data=
32,32,32,32,0,32,32,32,32,32,32,
45,45,45,0,0,45,0,0,0,45,45,
32,32,32,0,32,32,32,32,0,32,32,
36,36,36,0,0,36,36,36,0,36,36,
35,35,35,0,0,35,35,35,0,35,35,
38,38,38,0,0,38,38,0,0,38,38,
30,30,30,30,0,30,30,0,30,30,30,
26,0,26,26,26,26,26,26,26,26,26,
37,37,37,0,0,0,0,37,37,37,37,
0,0,0,0,0,0,0,0,0,0,0,
0,0,0,0,0,0,0,0,0,0,0,
0,0,0,0,0,0,0,0,0,0,0,
0,0,0,0,0,0,0,0,0,0,0.