[layer]
type=Tile Layer 1
data=
1,1,1,1,1,1,0,1,1,1,1,
1,1,1,0,0,8,0,21,1,1,1,
16,1,1,21,0,0,1,1,16,1,1,
1,17,1,0,0,21,1,1,17,1,1,
1,16,0,21,0,0,16,1,1,1,1,
1,17,21,1,1,0,0,17,1,1,1,
16,1,0,21,1,0,0,1,1,16,1,
1,1,1,21,0,0,0,0,1,1,1,
1,1,1,0,0,0,0,21,1,1,1,
0,21,0,0,1,0,1,1,17,1,1,
0,1,1,1,1,21,1,1,1,1,1,
21,1,1,1,1,0,0,1,1,1,1,
24,0,0,1,16,0,21,1,16,1,1,
1,1,0,1,1,0,21,0,1,1,1,
0,1,1,1,1,1,1,1,1,1,1,
1,1,1,1,24,1,1,21,0,1,1,
1,0,21,0,0,1,1,1,0,0,1,
0,0,0,1,1,1,1,1,1,0,0,
1,1,0,1,1,1,1,1,1,1,21,
0,0,0,0,0,0,0,0,0,0,0,
0,0,0,0,0,0,0,0,0,0,0,
0,0,0,0,0,0,0,0,0,0,0,
0,0,0,0,0,0,0,0,0,0,0.
[layer]
type=Tile Layer 2
data=
62,62,62,62,62,62,0,62,62,62,62,
130,130,130,0,0,0,0,0,130,130,130,
38,77,77,0,0,0,77,77,38,77,77,
83,41,83,0,0,0,83,83,41,83,83,
91,45,0,0,0,0,45,91,91,91,91,
80,40,0,80,80,0,0,40,80,80,80,
41,82,0,0,82,0,0,82,82,41,82,
81,81,81,0,0,0,0,0,81,81,81,
79,79,79,0,0,0,0,0,79,79,79,
0,0,0,0,72,0,72,72,36,72,72,
0,57,57,57,57,0,57,57,57,57,57,
0,63,63,63,63,0,0,63,63,63,63,
0,0,0,93,46,0,0,93,46,93,93,
61,61,0,61,61,0,0,0,61,61,61,
0,43,43,43,43,43,43,43,43,43,43,
81,81,81,81,0,81,81,0,0,81,81,
59,0,0,0,0,59,59,59,0,0,59,
0,0,0,58,58,58,58,58,58,0,0,
47,47,0,47,47,47,47,47,47,47,0,
0,0,0,0,0,0,0,0,0,0,0,
0,0,0,0,0,0,0,0,0,0,0,
0,0,0,0,0,0,0,0,0,0,0,
0,0,0,0,0,0,0,0,0,0,0.