[layer]
type=Tile Layer 1
data=
21,1,1,1,0,1,1,1,0,1,1,
0,1,0,1,0,1,0,1,0,1,21,
21,1,0,1,0,1,1,1,0,1,1,
0,1,0,1,0,0,0,0,0,0,21,
21,5,1,6,0,1,1,1,1,1,1,
0,0,0,0,0,0,0,0,0,0,0,
0,0,0,0,0,0,0,0,0,0,0,
0,0,0,0,0,0,0,0,0,0,0,
0,0,0,0,0,0,0,0,0,0,0,
0,0,0,0,0,0,0,0,0,0,0,
0,0,0,0,0,0,0,0,0,0,0.
[layer]
type=Tile Layer 2
data=
0,28,28,28,0,28,28,28,0,28,28,
0,31,0,31,0,31,0,31,0,31,0,
0,30,0,30,0,30,30,30,0,30,30,
0,29,0,29,0,0,0,0,0,0,0,
0,23,23,23,0,23,23,23,23,23,23,
0,0,0,0,0,0,0,0,0,0,0,
0,0,0,0,0,0,0,0,0,0,0,
0,0,0,0,0,0,0,0,0,0,0,
0,0,0,0,0,0,0,0,0,0,0,
0,0,0,0,0,0,0,0,0,0,0,
0,0,0,0,0,0,0,0,0,0,0.