[layer]
type=Tile Layer 1
data=
17,17,2,2,2,1,0,19,19,19,1,
21,16,0,0,8,0,0,0,0,16,0,
2,1,1,2,0,1,2,2,1,2,1,
1,2,2,2,0,2,1,1,2,1,1,
2,17,17,19,2,17,19,2,19,0,1,
0,18,18,18,18,1,16,16,2,2,1,
0,19,19,19,0,0,8,0,0,21,0,
1,16,0,16,24,1,16,1,16,16,1,
2,1,21,19,17,1,17,2,19,1,24,
0,0,0,18,0,21,0,18,0,8,0,
19,1,2,0,17,2,19,19,2,17,1,
0,18,21,0,0,18,0,24,0,18,0,
19,17,21,2,2,2,17,1,1,17,0,
21,16,16,16,16,1,16,1,1,1,1,
0,19,19,19,0,19,0,21,0,0,0,
16,2,21,16,8,18,0,2,18,18,1,
1,17,17,1,17,1,1,17,17,0,1,
0,18,2,1,21,16,18,2,16,18,1,
0,0,0,0,0,17,0,0,0,17,21,
16,16,16,1,1,1,0,16,24,16,21,
0,0,0,0,0,19,0,19,0,0,0,
2,1,2,2,21,2,7,2,1,2,1,
8,1,2,1,2,1,2,2,21,2,1,
21,7,0,16,0,0,0,0,0,16,0,
2,1,0,2,0,2,1,1,2,1,21,
0,2,0,21,0,2,0,0,0,0,0,
0,17,1,1,17,17,0,1,17,17,1,
16,2,18,18,16,2,1,1,16,2,21,
2,17,0,2,17,2,17,17,19,19,1,
16,1,16,16,21,16,16,1,16,1,1,
0,0,0,19,0,0,0,19,21,0,0,
0,16,21,18,0,2,0,18,0,18,1,
21,17,0,0,0,17,0,17,0,0,0,
18,16,18,1,18,2,0,18,1,1,21,
0,0,0,21,0,19,0,0,0,19,0,
0,16,16,16,0,1,16,16,21,1,1,
0,0,0,19,0,21,24,19,0,0,0,
2,1,21,1,2,2,0,1,2,2,1,
0,19,0,0,21,19,0,0,0,0,0,
0,1,1,2,0,2,2,1,1,2,21,
0,0,0,2,0,0,0,0,0,2,21,
1,1,21,1,1,1,1,1,0,1,1,
0,0,0,8,0,1,0,0,0,1,21,
16,1,16,16,0,16,21,16,1,16,1,
21,1,0,0,0,1,0,0,0,0,0,
21,1,24,1,1,1,1,1,1,1,1,
0,2,0,0,0,0,0,2,1,2,21,
1,1,1,1,1,1,21,1,1,1,0,
1,17,1,1,17,17,17,17,17,0,1,
21,16,0,2,18,1,2,1,16,18,1,
0,1,0,0,0,0,0,0,21,1,0,
2,1,2,1,2,1,2,1,21,2,0,
0,0,0,19,0,0,0,21,0,19,0,
1,16,21,16,0,1,16,16,16,1,1,
1,1,1,1,1,1,1,1,1,1,21,
21,1,1,1,1,1,1,1,1,1,1,
17,17,1,0,1,1,17,1,17,17,1,
16,1,1,16,1,16,0,16,16,16,1,
0,2,0,2,0,1,0,2,21,2,0,
0,1,0,21,0,1,0,1,0,0,0,
2,2,1,2,1,2,2,1,2,0,1,
8,1,1,1,21,1,1,1,1,1,1,
7,1,0,0,0,1,0,0,0,21,0,
0,1,0,1,1,1,21,1,1,1,1,
0,17,0,17,0,0,0,17,0,0,0,
1,1,0,1,0,1,0,1,21,1,1,
0,0,0,1,1,1,21,1,0,1,0,
1,2,2,2,1,2,2,2,21,1,1,
1,1,1,1,1,1,1,1,21,1,1,
0,1,0,0,0,0,21,1,0,0,0,
0,1,0,1,1,2,21,2,2,2,1,
0,0,21,2,2,2,0,0,0,0,0,
21,1,1,1,8,1,1,1,1,1,0,
0,2,2,2,0,0,0,21,8,2,0,
1,1,21,1,0,1,1,1,0,1,1,
1,1,21,1,1,1,0,1,1,1,0,
0,0,0,0,0,0,0,0,0,0,0,
0,0,0,0,0,0,0,0,0,0,0,
0,0,0,0,0,0,0,0,0,0,0,
0,0,0,0,0,0,0,0,0,0,0.
[layer]
type=Tile Layer 2
data=
101,101,202,202,202,202,0,202,202,202,202,
0,151,0,0,0,0,0,0,0,151,0,
200,200,200,200,0,200,200,200,200,200,200,
184,184,184,184,0,184,184,184,184,184,184,
184,92,92,184,184,92,184,184,184,0,184,
0,184,184,184,184,184,92,92,184,184,184,
0,300,300,300,0,0,0,0,0,0,0,
298,149,0,149,0,298,149,298,149,149,298,
298,298,0,298,149,298,149,298,298,298,0,
0,0,0,273,0,0,0,273,0,0,0,
181,181,181,0,90,181,181,181,181,90,181,
0,271,0,0,0,271,0,0,0,271,0,
196,98,0,196,196,196,98,196,196,98,0,
0,97,97,97,97,194,97,194,194,194,194,
0,193,193,193,0,193,0,0,0,0,0,
132,265,0,132,0,265,0,265,265,265,265,
176,88,88,176,88,176,176,88,88,0,176,
0,176,176,176,0,88,176,176,88,176,176,
0,0,0,0,0,95,0,0,0,95,0,
141,141,141,282,282,282,0,141,0,141,0,
0,0,0,0,0,187,0,187,0,0,0,
258,258,258,258,0,258,0,258,258,258,258,
0,256,256,256,256,256,256,256,0,256,256,
0,0,0,127,0,0,0,0,0,127,0,
184,184,0,184,0,184,184,184,184,184,0,
0,182,0,0,0,182,0,0,0,0,0,
0,90,181,181,90,90,0,181,90,90,181,
83,167,167,167,83,167,167,167,83,167,0,
166,83,0,166,83,166,83,83,166,166,166,
83,166,83,83,0,83,83,166,83,166,166,
0,0,0,179,0,0,0,179,0,0,0,
0,89,0,178,0,178,0,178,0,178,178,
0,88,0,0,0,88,0,88,0,0,0,
161,80,161,161,161,161,0,161,161,161,0,
0,0,0,0,0,160,0,0,0,160,0,
0,79,79,79,0,159,79,79,0,159,159,
0,0,0,258,0,0,0,258,0,0,0,
170,170,0,170,170,170,0,170,170,170,170,
0,169,0,0,0,169,0,0,0,0,0,
0,155,155,155,0,155,155,155,155,155,0,
0,0,0,154,0,0,0,0,0,154,0,
153,153,0,153,153,153,153,153,0,153,153,
0,0,0,0,0,246,0,0,0,246,0,
81,163,81,81,0,81,0,81,163,81,163,
0,162,0,0,0,162,0,0,0,0,0,
0,222,0,222,222,222,222,222,222,222,222,
0,147,0,0,0,0,0,147,147,147,0,
146,146,146,146,146,146,0,146,146,146,0,
157,78,157,157,78,78,78,78,78,0,157,
0,78,0,157,157,157,157,157,78,157,157,
0,156,0,0,0,0,0,0,0,156,0,
143,143,143,143,143,143,143,143,0,143,0,
0,0,0,142,0,0,0,0,0,142,0,
140,70,0,70,0,140,70,70,70,140,140,
151,151,151,151,151,151,151,151,151,151,0,
0,150,150,150,150,150,150,150,150,150,150,
74,74,149,0,149,149,74,149,74,74,149,
68,137,137,68,137,68,0,68,68,68,137,
0,137,0,137,0,137,0,137,0,137,0,
0,136,0,0,0,136,0,136,0,0,0,
146,146,146,146,146,146,146,146,146,0,146,
0,219,219,219,0,219,219,219,219,219,219,
0,217,0,0,0,217,0,0,0,0,0,
0,133,0,133,133,133,0,133,133,133,133,
0,66,0,66,0,0,0,66,0,0,0,
132,132,0,132,0,132,0,132,0,132,132,
0,0,0,120,120,120,0,120,0,120,0,
119,119,119,119,119,119,119,119,0,119,119,
118,118,118,118,118,118,118,118,0,118,118,
0,106,0,0,0,0,0,106,0,0,0,
0,105,0,105,105,105,0,105,105,105,105,
0,0,0,104,104,104,0,0,0,0,0,
0,154,154,154,0,154,154,154,154,154,0,
0,153,153,153,0,0,0,0,0,153,0,
101,101,0,101,0,101,101,101,0,101,101,
100,100,0,100,100,100,0,100,100,100,0,
0,0,0,0,0,0,0,0,0,0,0,
0,0,0,0,0,0,0,0,0,0,0,
0,0,0,0,0,0,0,0,0,0,0,
0,0,0,0,0,0,0,0,0,0,0.