[layer]
type=Tile Layer 1
data=
3,0,1,0,4,0,21,1,0,1,1,
5,8,1,0,1,0,21,1,0,6,0,
1,1,4,0,3,1,21,1,4,1,0,
0,1,1,3,3,17,21,1,17,1,0,
24,1,0,16,6,1,3,1,21,1,0,
0,6,0,1,0,4,1,1,21,1,1,
0,0,0,16,0,4,1,3,21,1,1,
0,0,0,1,0,3,5,0,21,1,1,
0,0,0,0,0,6,0,0,21,1,1,
0,0,0,0,0,0,0,0,0,0,0,
0,0,0,0,0,0,0,0,0,0,0,
0,0,0,0,0,0,0,0,0,0,0,
0,0,0,0,0,0,0,0,0,0,0.
[layer]
type=Tile Layer 2
data=
84,0,84,0,84,0,0,84,0,84,84,
124,0,124,0,124,0,0,124,0,124,0,
74,74,74,0,74,74,0,74,74,74,0,
0,73,73,73,73,36,0,73,36,73,0,
0,108,0,54,108,108,108,108,0,108,0,
0,71,0,71,0,71,71,71,0,71,71,
0,0,0,35,0,70,70,70,0,70,70,
0,0,0,69,0,69,69,0,0,69,69,
0,0,0,0,0,68,0,0,0,68,68,
0,0,0,0,0,0,0,0,0,0,0,
0,0,0,0,0,0,0,0,0,0,0,
0,0,0,0,0,0,0,0,0,0,0,
0,0,0,0,0,0,0,0,0,0,0.