[layer]
type=Tile Layer 1
data=
0,1,1,0,5,1,1,1,1,1,0,
0,1,0,0,0,0,0,0,0,1,0,
0,1,6,0,1,1,1,1,1,1,0,
0,1,0,0,0,0,0,0,0,1,0,
0,1,1,1,1,1,1,0,4,1,0,
0,0,0,0,0,0,0,0,0,0,0,
0,0,0,0,0,0,0,0,0,0,0,
0,0,0,0,0,0,0,0,0,0,0,
0,0,0,0,0,0,0,0,0,0,0,
0,0,0,0,0,0,0,0,0,0,0,
0,0,0,0,0,0,0,0,0,0,0.
[layer]
type=Tile Layer 2
data=
0,26,26,0,26,26,26,26,26,26,0,
0,28,0,0,0,0,0,0,0,28,0,
0,26,26,0,26,26,26,26,26,26,0,
0,28,0,0,0,0,0,0,0,28,0,
0,26,26,26,26,26,26,0,26,26,0,
0,0,0,0,0,0,0,0,0,0,0,
0,0,0,0,0,0,0,0,0,0,0,
0,0,0,0,0,0,0,0,0,0,0,
0,0,0,0,0,0,0,0,0,0,0,
0,0,0,0,0,0,0,0,0,0,0,
0,0,0,0,0,0,0,0,0,0,0.