[layer]
type=Tile Layer 1
data=
1,1,1,1,0,1,1,1,0,1,0,
1,9,1,1,0,1,6,0,0,1,1,
1,1,1,3,0,0,0,0,0,1,1,
6,0,0,0,0,1,1,0,0,0,0,
1,0,4,1,1,3,1,0,1,1,0,
1,0,1,1,3,9,1,1,1,1,0,
1,0,1,1,1,1,1,1,9,1,0,
1,0,1,1,1,1,0,1,1,1,0,
0,0,1,0,0,0,0,0,0,0,0,
0,0,0,0,0,0,0,0,0,0,0,
0,0,0,0,0,0,0,0,0,0,0.
[layer]
type=Tile Layer 2
data=
37,27,27,37,0,37,27,37,0,54,0,
37,27,27,37,0,37,37,0,0,37,37,
42,30,30,42,0,0,0,0,0,42,42,
60,0,0,0,0,42,42,0,0,0,0,
54,0,37,27,27,27,37,0,37,37,0,
48,0,33,24,24,24,24,24,24,33,0,
48,0,33,24,24,24,24,24,24,33,0,
70,0,70,50,50,70,0,70,50,70,0,
0,0,60,0,0,0,0,0,0,0,0,
0,0,0,0,0,0,0,0,0,0,0,
0,0,0,0,0,0,0,0,0,0,0.