[layer]
type=Tile Layer 1
data=
0,1,1,1,0,0,0,1,1,1,0,
23,1,1,1,0,0,0,1,1,1,23,
0,1,1,2,0,0,0,1,1,2,0,
0,2,1,1,0,8,8,2,1,1,0,
23,1,2,1,8,0,0,2,1,1,23,
0,1,1,1,0,8,0,1,1,1,0,
0,1,2,1,0,7,0,1,1,2,0,
7,1,1,1,0,0,0,1,1,1,23,
0,1,1,1,7,0,0,1,1,1,0,
0,0,0,0,0,0,0,0,0,0,0,
0,0,0,0,0,0,0,0,0,0,0,
0,0,0,0,0,0,0,0,0,0,0,
0,0,0,0,0,0,0,0,0,0,0.
[layer]
type=Tile Layer 2
data=
0,82,82,82,0,0,0,82,82,82,0,
0,82,82,82,0,0,0,82,82,82,0,
0,72,72,72,0,0,0,72,72,72,0,
0,144,144,144,0,0,0,144,144,144,0,
0,108,108,108,0,0,0,108,108,108,0,
0,105,105,105,0,0,0,105,105,105,0,
0,105,105,105,0,0,0,105,105,105,0,
0,105,105,105,0,0,0,105,105,105,0,
0,105,105,105,0,0,0,105,105,105,0,
0,0,0,0,0,0,0,0,0,0,0,
0,0,0,0,0,0,0,0,0,0,0,
0,0,0,0,0,0,0,0,0,0,0,
0,0,0,0,0,0,0,0,0,0,0.