[layer]
type=Tile Layer 1
data=
0,0,21,1,1,1,0,1,0,1,1,
0,21,0,1,0,1,0,1,0,1,0,
1,1,1,1,1,1,1,0,1,1,1,
1,1,1,1,1,1,1,1,1,1,0,
0,0,21,0,0,1,1,1,1,1,0,
1,1,1,1,0,1,1,1,1,1,21,
1,1,1,1,0,0,21,0,0,1,0,
1,1,1,1,0,0,0,0,21,1,0,
1,1,1,1,0,21,0,0,0,1,0,
1,1,1,1,0,21,0,0,0,1,0,
1,1,0,1,0,1,1,1,0,1,0,
1,1,0,1,0,1,1,1,0,1,21,
1,1,21,1,1,1,1,1,0,1,1,
0,1,21,1,0,1,1,1,0,1,0,
1,1,1,1,1,1,1,1,1,0,1,
1,1,21,0,0,0,0,0,0,1,1,
1,1,0,1,1,1,1,1,21,1,1,
0,0,0,0,0,0,0,0,0,0,0,
0,0,0,0,0,0,0,0,0,0,0,
0,0,0,0,0,0,0,0,0,0,0,
0,0,0,0,0,0,0,0,0,0,0.
[layer]
type=Tile Layer 2
data=
0,0,0,84,84,84,0,84,0,84,84,
0,0,0,90,0,90,0,90,0,90,0,
62,62,62,62,62,62,62,0,62,62,62,
62,62,62,62,62,62,62,62,62,62,0,
0,0,0,0,0,82,82,82,82,82,0,
65,65,65,65,0,65,65,65,65,65,0,
79,79,79,79,0,0,0,0,0,79,0,
72,72,72,72,0,0,0,0,0,72,0,
71,71,71,71,0,0,0,0,0,71,0,
70,70,70,70,0,0,0,0,0,70,0,
62,62,0,62,0,62,62,62,0,62,0,
62,62,0,62,0,62,62,62,0,62,0,
49,49,0,49,49,49,49,49,0,49,49,
0,60,0,60,0,60,60,60,0,60,0,
42,42,42,42,42,42,42,42,42,0,42,
59,59,0,0,0,0,0,0,0,59,59,
47,47,0,47,47,47,47,47,0,47,47,
0,0,0,0,0,0,0,0,0,0,0,
0,0,0,0,0,0,0,0,0,0,0,
0,0,0,0,0,0,0,0,0,0,0,
0,0,0,0,0,0,0,0,0,0,0.