[layer]
type=Tile Layer 1
data=
0,0,0,1,0,0,5,1,0,0,0,
5,4,1,1,0,4,1,1,1,1,1,
0,1,0,0,0,6,0,21,0,0,0,
21,3,0,1,0,1,0,1,3,1,1,
0,4,0,1,0,0,21,1,0,0,0,
0,5,21,1,1,1,1,1,0,4,0,
0,4,0,0,0,21,0,0,0,1,0,
0,1,1,5,1,6,6,1,1,1,21,
0,1,6,5,0,21,0,0,1,1,0,
0,1,0,1,0,1,0,4,5,1,1,
0,6,21,0,0,1,0,0,0,0,0,
1,1,21,1,1,6,4,4,1,1,1,
0,1,0,6,0,0,0,0,21,1,0,
1,1,1,0,1,5,1,1,6,5,1,
0,0,0,4,0,0,0,1,0,21,0,
0,1,3,6,5,1,21,1,1,1,1,
0,3,0,0,0,0,0,1,21,0,0,
0,0,0,0,0,0,0,0,0,0,0,
0,0,0,0,0,0,0,0,0,0,0,
0,0,0,0,0,0,0,0,0,0,0,
0,0,0,0,0,0,0,0,0,0,0.
[layer]
type=Tile Layer 2
data=
0,0,0,83,0,0,83,83,0,0,0,
72,72,72,72,0,72,72,72,72,72,72,
0,90,0,0,0,90,0,0,0,0,0,
0,89,0,89,0,89,0,89,89,89,89,
0,81,0,81,0,0,0,81,0,0,0,
0,80,0,80,80,80,80,80,0,80,0,
0,78,0,0,0,0,0,0,0,78,0,
0,64,64,64,64,64,64,64,64,64,0,
0,70,70,70,0,0,0,0,70,70,0,
0,69,0,69,0,69,0,69,69,69,69,
0,62,0,0,0,62,0,0,0,0,0,
49,49,0,49,49,49,49,49,49,49,49,
0,60,0,60,0,0,0,0,0,60,0,
48,48,48,0,48,48,48,48,48,48,48,
0,0,0,59,0,0,0,59,0,0,0,
0,52,52,52,52,52,0,52,52,52,52,
0,57,0,0,0,0,0,57,0,0,0,
0,0,0,0,0,0,0,0,0,0,0,
0,0,0,0,0,0,0,0,0,0,0,
0,0,0,0,0,0,0,0,0,0,0,
0,0,0,0,0,0,0,0,0,0,0.