[layer]
type=Tile Layer 1
data=
0,0,4,4,1,1,5,1,3,0,0,
0,4,3,5,21,21,21,1,1,1,0,
1,3,3,0,0,0,0,7,1,1,3,
4,6,0,7,0,0,0,0,0,5,1,
4,0,0,0,0,0,0,0,0,0,1,
17,0,0,0,0,0,0,0,0,0,1,
1,16,3,16,21,0,21,6,3,3,1,
5,6,1,6,21,0,21,4,1,1,6,
0,5,1,5,21,0,21,1,5,6,0,
0,0,0,0,0,0,0,0,0,0,0,
0,0,0,0,0,0,0,0,0,0,0,
0,0,0,0,0,0,0,0,0,0,0,
0,0,0,0,0,0,0,0,0,0,0.
[layer]
type=Tile Layer 2
data=
0,0,61,61,61,61,61,61,61,0,0,
0,61,61,61,0,0,0,61,61,61,0,
78,78,78,0,0,0,0,0,78,78,78,
78,78,0,0,0,0,0,0,0,78,78,
52,0,0,0,0,0,0,0,0,0,52,
26,0,0,0,0,0,0,0,0,0,52,
47,23,47,23,0,0,0,47,47,47,47,
45,45,45,45,0,0,0,45,45,45,45,
0,48,48,48,0,0,0,48,48,48,0,
0,0,0,0,0,0,0,0,0,0,0,
0,0,0,0,0,0,0,0,0,0,0,
0,0,0,0,0,0,0,0,0,0,0,
0,0,0,0,0,0,0,0,0,0,0.