[layer]
type=Tile Layer 1
data=
0,0,1,2,1,0,0,0,5,2,21,
0,1,1,1,0,0,0,3,6,1,21,
1,1,2,0,0,0,2,1,3,21,0,
4,1,0,8,0,3,1,1,21,0,0,
1,0,0,0,6,1,3,21,0,7,1,
0,0,0,1,2,2,21,0,0,1,1,
0,0,1,1,1,21,0,0,4,5,1,
0,1,1,1,21,0,0,6,4,1,0,
1,1,6,21,0,0,1,1,5,0,0,
0,0,0,0,0,0,0,0,0,0,0,
0,0,0,0,0,0,0,0,0,0,0,
0,0,0,0,0,0,0,0,0,0,0,
0,0,0,0,0,0,0,0,0,0,0.
[layer]
type=Tile Layer 2
data=
0,0,74,74,74,0,0,0,74,74,0,
0,73,73,73,0,0,0,73,73,73,0,
65,65,65,0,0,0,65,65,65,0,0,
96,96,0,0,0,96,96,96,0,0,0,
94,0,0,0,94,94,94,0,0,0,94,
0,0,0,62,62,62,0,0,0,62,62,
0,0,61,61,61,0,0,0,61,61,61,
0,60,60,60,0,0,0,60,60,60,0,
59,59,59,0,0,0,59,59,59,0,0,
0,0,0,0,0,0,0,0,0,0,0,
0,0,0,0,0,0,0,0,0,0,0,
0,0,0,0,0,0,0,0,0,0,0,
0,0,0,0,0,0,0,0,0,0,0.