[layer]
type=Tile Layer 1
data=
1,1,0,1,21,5,1,6,0,1,1,
0,1,0,4,0,0,0,1,0,1,21,
5,6,1,1,1,6,1,1,0,1,1,
21,5,0,1,0,0,0,1,0,1,0,
0,1,21,1,0,4,1,5,0,1,1,
0,0,0,3,0,1,1,1,0,0,0,
1,1,5,1,1,1,4,1,21,0,0,
0,1,5,1,0,1,1,5,21,0,0,
0,1,3,1,21,1,1,1,0,3,1,
0,0,0,1,0,1,0,0,21,6,1,
21,6,0,1,1,1,1,1,0,6,1,
0,1,21,1,6,1,1,1,0,4,1,
0,1,0,1,6,1,1,4,0,1,1,
1,1,3,4,3,1,1,1,0,1,1,
21,6,0,1,0,0,0,4,0,1,1,
0,0,0,0,0,0,0,0,0,0,0,
0,0,0,0,0,0,0,0,0,0,0,
0,0,0,0,0,0,0,0,0,0,0,
0,0,0,0,0,0,0,0,0,0,0.
[layer]
type=Tile Layer 2
data=
66,66,0,66,0,66,66,66,0,66,66,
0,74,0,74,0,0,0,74,0,74,0,
47,47,47,47,47,47,47,47,0,47,47,
0,66,0,66,0,0,0,66,0,66,0,
0,65,0,65,0,65,65,65,0,65,65,
0,0,0,59,0,59,59,59,0,0,0,
53,53,53,53,53,53,53,53,0,0,0,
0,58,58,58,0,58,58,58,0,0,0,
0,46,46,46,0,46,46,46,0,46,46,
0,0,0,50,0,50,0,0,0,50,50,
0,44,0,44,44,44,44,44,0,44,44,
0,43,0,43,43,43,43,43,0,43,43,
0,42,0,42,42,42,42,42,0,42,42,
33,33,33,33,33,33,33,33,0,33,33,
0,47,0,47,0,0,0,47,0,47,47,
0,0,0,0,0,0,0,0,0,0,0,
0,0,0,0,0,0,0,0,0,0,0,
0,0,0,0,0,0,0,0,0,0,0,
0,0,0,0,0,0,0,0,0,0,0.