[layer]
type=Tile Layer 1
data=
0,4,1,1,1,0,1,1,1,3,0,
0,5,1,1,1,21,5,1,1,6,0,
0,0,5,6,21,0,21,5,6,0,0,
0,0,0,21,4,1,3,21,0,0,0,
0,0,21,0,1,1,1,0,21,0,0,
0,0,0,21,5,1,6,21,0,0,0,
0,0,4,3,21,0,21,4,3,0,0,
0,4,1,1,3,21,4,1,1,3,0,
0,5,1,1,6,0,5,1,1,6,0,
0,0,0,0,0,0,0,0,0,0,0,
0,0,0,0,0,0,0,0,0,0,0,
0,0,0,0,0,0,0,0,0,0,0,
0,0,0,0,0,0,0,0,0,0,0.
[layer]
type=Tile Layer 2
data=
0,89,89,89,89,0,89,89,89,89,0,
0,89,89,89,89,0,89,89,89,89,0,
0,0,79,79,0,0,0,79,79,0,0,
0,0,0,0,78,78,78,0,0,0,0,
0,0,0,0,76,76,76,0,0,0,0,
0,0,0,0,74,74,74,0,0,0,0,
0,0,72,72,0,0,0,72,72,0,0,
0,70,70,70,70,0,70,70,70,70,0,
0,70,70,70,70,0,70,70,70,70,0,
0,0,0,0,0,0,0,0,0,0,0,
0,0,0,0,0,0,0,0,0,0,0,
0,0,0,0,0,0,0,0,0,0,0,
0,0,0,0,0,0,0,0,0,0,0.