[layer]
type=Tile Layer 1
data=
0,0,0,21,1,1,1,21,0,0,0,
8,0,21,4,1,1,17,3,21,0,0,
8,21,1,1,1,21,1,1,1,21,0,
21,4,17,6,1,1,1,5,17,3,21,
24,1,6,0,0,0,0,0,5,1,0,
0,1,4,1,1,1,1,1,3,1,0,
0,1,1,1,1,1,1,1,1,1,0,
0,1,1,17,0,0,0,17,1,1,0,
0,1,6,0,0,0,0,0,5,1,0,
0,0,0,0,0,0,0,0,0,0,0,
0,0,0,0,0,0,0,0,0,0,0,
0,0,0,0,0,0,0,0,0,0,0,
0,0,0,0,0,0,0,0,0,0,0.
[layer]
type=Tile Layer 2
data=
0,0,0,0,62,62,62,0,0,0,0,
0,0,0,90,90,90,45,90,0,0,0,
0,0,78,78,78,0,78,78,78,0,0,
0,44,22,44,44,44,44,44,22,44,0,
0,72,72,0,0,0,0,0,72,72,0,
0,43,43,43,43,43,43,43,43,43,0,
0,43,43,43,43,43,43,43,43,43,0,
0,48,48,24,0,0,0,24,48,48,0,
0,48,48,0,0,0,0,0,48,48,0,
0,0,0,0,0,0,0,0,0,0,0,
0,0,0,0,0,0,0,0,0,0,0,
0,0,0,0,0,0,0,0,0,0,0,
0,0,0,0,0,0,0,0,0,0,0.