[layer]
type=Tile Layer 1
data=
0,0,0,1,1,1,1,1,0,0,0,
0,0,0,1,1,1,1,1,0,0,0,
0,0,0,1,1,1,1,1,0,0,0,
0,0,0,0,0,0,0,0,0,0,0,
0,11,11,11,11,11,11,11,11,11,0,
0,11,0,1,1,1,1,1,0,11,0,
0,11,0,0,0,0,0,0,0,11,0,
0,11,11,11,11,11,11,11,11,11,0,
0,0,0,0,0,0,0,0,0,0,0,
0,0,0,0,0,0,0,0,0,0,0,
0,0,0,0,0,0,0,0,0,0,0.
[layer]
type=Tile Layer 2
data=
0,0,0,31,31,31,31,31,0,0,0,
0,0,0,31,31,31,31,31,0,0,0,
0,0,0,31,31,31,31,31,0,0,0,
0,0,0,0,0,0,0,0,0,0,0,
0,25,25,25,25,25,25,25,25,25,0,
0,31,0,31,31,31,31,31,0,31,0,
0,31,0,0,0,0,0,0,0,31,0,
0,25,25,25,25,25,25,25,25,25,0,
0,0,0,0,0,0,0,0,0,0,0,
0,0,0,0,0,0,0,0,0,0,0,
0,0,0,0,0,0,0,0,0,0,0.