[layer]
type=Tile Layer 1
data=
0,0,0,0,0,0,2,0,0,0,0,
0,0,0,0,4,2,2,0,0,0,0,
0,0,0,4,16,6,2,0,0,0,0,
0,0,4,1,6,0,0,0,0,24,0,
0,16,2,16,0,0,0,0,0,0,2,
21,1,1,1,1,21,1,1,1,1,21,
21,1,1,1,1,1,1,1,1,1,21,
21,1,1,1,1,1,1,1,1,1,21,
0,0,0,0,0,0,0,0,0,0,0,
0,0,0,0,0,0,0,0,0,0,0,
0,0,0,0,0,0,0,0,0,0,0,
0,0,0,0,0,0,0,0,0,0,0,
0,0,0,0,0,0,0,0,0,0,0.
[layer]
type=Tile Layer 2
data=
0,0,0,0,0,0,45,0,0,0,0,
0,0,0,0,45,45,45,0,0,0,0,
0,0,0,40,20,40,40,0,0,0,0,
0,0,60,60,60,0,0,0,0,0,0,
0,20,40,20,0,0,0,0,0,0,40,
0,36,36,36,36,0,36,36,36,36,0,
0,30,30,30,30,30,30,30,30,30,0,
0,29,29,29,29,29,29,29,29,29,0,
0,0,0,0,0,0,0,0,0,0,0,
0,0,0,0,0,0,0,0,0,0,0,
0,0,0,0,0,0,0,0,0,0,0,
0,0,0,0,0,0,0,0,0,0,0,
0,0,0,0,0,0,0,0,0,0,0.