[layer]
type=Tile Layer 1
data=
0,21,1,16,1,0,0,16,0,0,0,
1,1,1,1,1,6,1,0,3,1,1,
0,16,16,1,0,5,0,0,7,21,0,
6,5,1,1,0,21,0,1,1,0,0,
0,1,6,0,1,0,0,0,21,0,1,
1,3,6,0,0,0,21,0,24,1,1,
16,1,16,1,1,1,4,0,1,16,1,
0,6,1,21,0,0,1,1,0,0,0,
6,0,0,21,1,16,1,1,0,4,0,
0,4,8,21,1,4,1,1,0,0,0,
21,0,0,1,16,3,6,16,0,0,1,
0,0,4,1,1,1,1,3,1,21,0,
0,21,0,1,16,5,3,1,1,1,0,
0,0,0,0,21,6,1,1,1,3,0,
0,0,1,0,0,3,0,0,1,1,21,
0,6,1,0,0,0,21,1,1,4,1,
21,0,0,0,1,0,4,1,4,1,1,
0,0,1,0,5,0,21,1,1,5,1,
0,0,0,0,0,0,0,6,1,1,0,
0,0,0,0,0,0,0,0,0,0,0,
0,0,0,0,0,0,0,0,0,0,0,
0,0,0,0,0,0,0,0,0,0,0,
0,0,0,0,0,0,0,0,0,0,0.
[layer]
type=Tile Layer 2
data=
0,0,87,43,87,0,0,43,0,0,0,
61,61,61,61,61,61,61,0,61,61,61,
0,64,64,129,0,129,0,0,0,0,0,
92,92,92,92,0,0,0,92,92,0,0,
0,91,91,0,91,0,0,0,0,0,91,
135,135,135,0,0,0,0,0,0,135,135,
28,57,28,57,57,57,57,0,57,28,57,
0,82,82,0,0,0,82,82,0,0,0,
81,0,0,0,81,40,81,81,0,81,0,
0,109,0,0,109,109,109,109,0,0,0,
0,0,0,72,36,72,72,36,0,0,72,
0,0,71,71,71,71,71,71,71,0,0,
0,0,0,63,31,63,63,63,63,63,0,
0,0,0,0,0,62,62,62,62,62,0,
0,0,61,0,0,61,0,0,61,61,0,
0,60,60,0,0,0,0,60,60,60,60,
0,0,0,0,59,0,59,59,59,59,59,
0,0,58,0,58,0,0,58,58,58,58,
0,0,0,0,0,0,0,58,58,58,0,
0,0,0,0,0,0,0,0,0,0,0,
0,0,0,0,0,0,0,0,0,0,0,
0,0,0,0,0,0,0,0,0,0,0,
0,0,0,0,0,0,0,0,0,0,0.