[layer]
type=Tile Layer 1
data=
6,1,1,1,6,1,0,1,1,6,1,
17,17,1,1,17,4,1,1,0,1,1,
0,3,1,1,0,1,21,3,1,1,1,
0,0,0,1,21,1,0,1,3,4,1,
1,16,16,1,0,6,7,1,1,16,1,
5,17,1,1,0,17,0,0,0,0,21,
1,5,5,1,7,1,1,6,1,1,21,
6,1,4,1,0,0,0,0,21,1,0,
1,1,5,1,8,1,4,4,0,1,21,
21,6,0,0,0,1,0,1,0,1,0,
0,6,1,1,1,4,0,1,0,1,21,
0,5,1,3,1,1,0,1,21,1,0,
21,5,1,1,1,1,7,1,0,3,0,
0,1,1,6,1,4,0,1,0,1,21,
8,1,3,1,6,1,8,1,21,6,1,
0,0,0,0,0,0,0,0,0,0,0,
0,0,0,0,0,0,0,0,0,0,0,
0,0,0,0,0,0,0,0,0,0,0,
0,0,0,0,0,0,0,0,0,0,0.
[layer]
type=Tile Layer 2
data=
54,54,54,54,54,54,0,54,54,54,54,
27,27,54,54,27,54,54,54,0,54,54,
0,63,63,63,0,63,0,63,63,63,63,
0,0,0,70,0,70,0,70,70,70,70,
82,41,41,82,0,82,0,82,82,41,82,
63,31,63,63,0,31,0,0,0,0,0,
75,75,75,75,0,75,75,75,75,75,0,
61,61,61,61,0,0,0,0,0,61,0,
72,72,72,72,0,72,72,72,0,72,0,
0,53,0,0,0,53,0,53,0,53,0,
0,52,52,52,52,52,0,52,0,52,0,
0,51,51,51,51,51,0,51,0,51,0,
0,75,75,75,75,75,0,75,0,75,0,
0,49,49,49,49,49,0,49,0,49,0,
0,86,86,86,86,86,0,86,0,86,86,
0,0,0,0,0,0,0,0,0,0,0,
0,0,0,0,0,0,0,0,0,0,0,
0,0,0,0,0,0,0,0,0,0,0,
0,0,0,0,0,0,0,0,0,0,0.