[layer]
type=Tile Layer 1
data=
1,1,1,1,1,0,1,1,1,1,1,
0,0,0,0,1,1,1,1,1,0,21,
0,1,1,1,1,1,1,1,1,21,0,
0,1,1,1,1,1,0,0,0,0,21,
0,1,1,1,1,21,0,0,1,1,1,
0,0,1,1,1,1,1,21,0,0,0,
1,0,0,1,1,1,1,1,1,1,21,
1,1,1,1,1,1,1,1,1,1,0,
1,1,1,0,0,1,1,1,1,1,0,
1,1,1,0,0,0,0,21,0,1,1,
1,1,0,0,1,1,1,0,0,0,21,
1,1,21,1,1,1,1,1,1,1,0,
1,1,0,0,1,1,1,1,1,21,0,
0,0,0,0,0,0,0,0,0,0,0,
0,0,0,0,0,0,0,0,0,0,0,
0,0,0,0,0,0,0,0,0,0,0,
0,0,0,0,0,0,0,0,0,0,0.
[layer]
type=Tile Layer 2
data=
48,48,48,48,48,0,48,48,48,48,48,
0,0,0,0,68,68,68,68,68,0,0,
0,60,60,60,60,60,60,60,60,0,0,
0,60,60,60,60,60,0,0,0,0,0,
0,59,59,59,59,0,0,0,59,59,59,
0,0,58,58,58,58,58,0,0,0,0,
46,0,0,46,46,46,46,46,46,46,0,
35,35,35,35,35,35,35,35,35,35,0,
45,45,45,0,0,45,45,45,45,45,0,
50,50,50,0,0,0,0,0,0,50,50,
49,49,0,0,49,49,49,0,0,0,0,
38,38,0,38,38,38,38,38,38,38,0,
47,47,0,0,47,47,47,47,47,0,0,
0,0,0,0,0,0,0,0,0,0,0,
0,0,0,0,0,0,0,0,0,0,0,
0,0,0,0,0,0,0,0,0,0,0,
0,0,0,0,0,0,0,0,0,0,0.