[layer]
type=Tile Layer 1
data=
1,1,0,1,1,1,1,1,1,1,1,
2,1,1,2,0,2,24,2,1,1,0,
1,2,1,0,2,2,2,2,1,1,1,
1,1,2,1,1,0,2,2,2,1,1,
0,8,0,0,0,2,0,2,1,1,0,
1,1,21,2,2,2,24,2,1,1,0,
24,2,1,2,21,2,1,1,2,1,1,
24,1,1,1,0,1,1,1,21,1,0,
0,1,1,1,24,1,1,1,21,1,0,
0,2,1,2,24,1,21,2,1,2,0,
8,1,2,1,0,1,21,2,2,2,0,
1,1,2,1,0,2,0,1,2,2,21,
0,2,1,2,21,2,0,2,24,0,0,
24,1,1,1,0,1,1,1,0,21,0,
2,2,1,1,1,2,2,1,0,2,1,
1,1,1,1,1,1,8,1,0,0,0,
1,1,1,1,8,1,1,1,21,0,0,
2,1,1,2,21,2,1,2,0,24,0,
24,0,0,1,0,1,1,1,0,0,21,
0,0,0,1,24,1,2,2,0,0,0,
1,1,1,1,21,1,1,1,1,1,1,
1,1,8,21,0,0,0,0,0,1,1,
2,1,0,0,8,0,0,2,2,2,1,
0,1,21,7,0,0,0,1,0,1,1,
1,1,2,1,2,2,2,2,21,1,1,
2,2,2,2,0,21,0,0,24,0,0,
2,2,2,2,21,0,0,0,24,2,1,
0,2,2,2,0,0,0,21,0,2,0,
1,2,1,2,2,1,1,1,1,2,21,
1,1,1,1,21,1,1,1,1,1,1,
1,1,21,1,24,1,1,1,1,1,1,
0,1,0,1,0,2,2,2,24,21,0,
1,1,21,1,24,1,1,1,1,1,1,
1,1,0,1,0,0,0,21,0,1,1,
1,1,0,1,0,0,0,1,21,1,1,
1,1,8,1,0,0,0,1,0,1,21,
2,2,0,1,8,21,0,2,2,1,0,
1,1,7,1,1,1,1,1,21,1,1,
1,1,1,1,1,1,7,1,21,1,1,
21,2,1,2,1,2,0,1,0,2,1,
0,1,1,1,1,1,1,1,21,1,1,
1,1,0,1,1,1,1,1,21,1,0,
0,2,7,2,1,2,1,1,21,1,0,
1,1,21,1,1,1,1,1,1,1,0,
0,1,0,1,0,2,2,1,1,2,21,
0,1,0,1,21,1,1,1,1,1,0,
1,1,1,1,0,2,2,1,2,2,21,
1,1,1,1,0,0,0,1,0,21,0,
2,2,2,2,0,0,0,1,0,0,0,
0,0,1,1,1,1,1,0,0,0,21,
0,0,1,1,1,1,1,0,24,0,21,
1,21,1,1,1,1,1,1,1,1,1,
2,0,2,0,21,24,1,2,1,2,1,
1,0,1,21,0,7,1,1,1,1,1,
2,0,1,0,0,21,2,1,2,2,1,
1,21,1,1,1,1,1,0,1,1,1,
2,0,2,2,1,2,1,0,0,0,21,
1,21,1,1,1,1,1,1,1,1,1,
1,21,1,1,1,1,1,0,1,1,1,
1,1,1,0,1,1,1,1,1,1,1,
1,1,1,0,1,1,1,1,1,1,1,
0,0,0,0,0,0,0,0,0,0,0,
0,0,0,0,0,0,0,0,0,0,0,
0,0,0,0,0,0,0,0,0,0,0,
0,0,0,0,0,0,0,0,0,0,0.
[layer]
type=Tile Layer 2
data=
110,110,0,110,110,110,110,110,110,110,110,
211,211,211,211,0,211,0,211,211,211,0,
110,110,110,0,110,110,110,110,110,110,110,
120,120,120,120,120,0,120,120,120,120,120,
0,0,0,0,0,255,0,255,255,255,0,
231,231,0,231,231,231,0,231,231,231,0,
0,187,187,187,0,187,187,187,187,187,187,
0,231,231,231,0,231,231,231,0,231,0,
0,229,229,229,0,229,229,229,0,229,0,
0,249,249,249,0,249,0,249,249,249,0,
0,246,246,246,0,246,0,246,246,246,0,
146,146,146,146,0,146,0,146,146,146,0,
0,223,223,223,0,223,0,223,0,0,0,
0,222,222,222,0,222,222,222,0,0,0,
104,104,104,104,104,104,104,104,0,104,104,
240,240,240,240,240,240,0,240,0,0,0,
240,240,240,240,0,240,240,240,0,0,0,
237,237,237,237,0,237,237,237,0,0,0,
0,0,0,216,0,216,216,216,0,0,0,
0,0,0,214,0,214,214,214,0,0,0,
100,100,100,100,0,100,100,100,100,100,100,
232,232,0,0,0,0,0,0,0,232,232,
231,231,0,0,0,0,0,231,231,231,231,
0,231,0,0,0,0,0,231,0,231,231,
98,98,98,98,98,98,98,98,0,98,98,
208,208,208,208,0,0,0,0,0,0,0,
207,207,207,207,0,0,0,0,0,207,207,
0,149,149,149,0,0,0,0,0,149,0,
104,104,104,104,104,104,104,104,104,104,0,
103,103,103,103,0,103,103,103,103,103,103,
160,160,0,160,0,160,160,160,160,160,160,
0,198,0,198,0,198,198,198,0,0,0,
157,157,0,157,0,157,157,157,157,157,157,
142,142,0,142,0,0,0,0,0,142,142,
140,140,0,140,0,0,0,140,0,140,140,
208,208,0,208,0,0,0,208,0,208,0,
190,190,0,190,0,0,0,190,190,190,0,
150,150,0,150,150,150,150,150,0,150,150,
150,150,150,150,150,150,0,150,0,150,150,
0,121,121,121,121,121,0,121,0,121,121,
0,107,107,107,107,107,107,107,0,107,107,
119,119,0,119,119,119,119,119,0,119,0,
0,180,0,180,180,180,180,180,0,180,0,
96,96,0,96,96,96,96,96,96,96,0,
0,118,0,118,0,118,118,118,118,118,0,
0,127,0,127,0,127,127,127,127,127,0,
101,101,101,101,0,101,101,101,101,101,0,
125,125,125,125,0,0,0,125,0,0,0,
114,114,114,114,0,0,0,114,0,0,0,
0,0,114,114,114,114,114,0,0,0,0,
0,0,168,168,168,168,168,0,0,0,0,
72,0,72,72,72,72,72,72,72,72,72,
151,0,151,0,0,0,151,151,151,151,151,
150,0,150,0,0,0,150,150,150,150,150,
89,0,89,0,0,0,89,89,89,89,89,
71,0,71,71,71,71,71,0,71,71,71,
87,0,87,87,87,87,87,0,0,0,0,
61,0,61,61,61,61,61,61,61,61,61,
68,0,68,68,68,68,68,0,68,68,68,
60,60,60,0,60,60,60,60,60,60,60,
60,60,60,0,60,60,60,60,60,60,60,
0,0,0,0,0,0,0,0,0,0,0,
0,0,0,0,0,0,0,0,0,0,0,
0,0,0,0,0,0,0,0,0,0,0,
0,0,0,0,0,0,0,0,0,0,0.