[layer]
type=Tile Layer 1
data=
6,1,1,1,1,1,1,3,6,0,1,
0,0,0,21,1,0,6,0,1,6,1,
3,0,1,1,1,0,1,21,5,1,1,
3,21,1,0,1,0,4,0,1,0,0,
1,21,1,0,6,0,1,3,1,1,1,
21,0,1,0,0,0,1,3,1,3,1,
21,0,1,4,1,1,1,6,1,4,1,
1,1,1,3,1,4,1,4,0,1,1,
0,0,1,1,4,0,1,1,3,1,1,
1,0,0,0,0,21,3,1,4,1,1,
4,21,0,0,0,0,1,4,1,1,1,
1,21,0,0,0,0,4,5,1,1,1,
1,0,21,0,0,0,1,1,6,6,1,
1,0,0,21,0,0,1,3,3,1,1,
21,0,1,3,1,1,1,6,1,3,1,
0,0,1,4,4,1,1,0,0,21,1,
0,0,4,1,3,1,1,21,0,0,1,
0,0,0,0,0,0,0,0,0,0,0,
0,0,0,0,0,0,0,0,0,0,0,
0,0,0,0,0,0,0,0,0,0,0,
0,0,0,0,0,0,0,0,0,0,0.
[layer]
type=Tile Layer 2
data=
60,60,60,60,60,60,60,60,60,0,60,
0,0,0,0,92,0,92,0,92,92,92,
82,0,82,82,82,0,82,0,82,82,82,
90,0,90,0,90,0,90,0,90,0,0,
73,0,73,0,73,0,73,73,73,73,73,
0,0,81,0,0,0,81,81,81,81,81,
0,0,64,64,64,64,64,64,64,64,64,
51,51,51,51,51,51,51,51,0,51,51,
0,0,65,65,65,0,65,65,65,65,65,
72,0,0,0,0,0,72,72,72,72,72,
64,0,0,0,0,0,64,64,64,64,64,
63,0,0,0,0,0,63,63,63,63,63,
62,0,0,0,0,0,62,62,62,62,62,
61,0,0,0,0,0,61,61,61,61,61,
0,0,49,49,49,49,49,49,49,49,49,
0,0,59,59,59,59,59,0,0,0,59,
0,0,58,58,58,58,58,0,0,0,58,
0,0,0,0,0,0,0,0,0,0,0,
0,0,0,0,0,0,0,0,0,0,0,
0,0,0,0,0,0,0,0,0,0,0,
0,0,0,0,0,0,0,0,0,0,0.