[layer]
type=Tile Layer 1
data=
1,1,1,0,21,0,1,0,1,1,1,
2,0,0,0,0,21,2,0,2,0,2,
1,0,1,0,1,0,1,7,1,21,1,
1,0,1,0,1,0,1,21,1,0,0,
1,1,1,0,1,0,1,1,1,21,0,
1,8,1,1,1,1,1,1,1,21,1,
0,0,0,0,0,0,0,0,0,0,0,
0,0,0,0,0,0,0,0,0,0,0,
0,0,0,0,0,0,0,0,0,0,0,
0,0,0,0,0,0,0,0,0,0,0,
0,0,0,0,0,0,0,0,0,0,0.
[layer]
type=Tile Layer 2
data=
35,35,35,0,0,0,35,0,35,35,35,
34,0,0,0,0,0,34,0,34,0,34,
49,0,49,0,49,0,49,0,49,0,49,
33,0,33,0,33,0,33,0,33,0,0,
32,32,32,0,32,0,32,32,32,0,0,
37,0,37,37,37,37,37,37,37,0,37,
0,0,0,0,0,0,0,0,0,0,0,
0,0,0,0,0,0,0,0,0,0,0,
0,0,0,0,0,0,0,0,0,0,0,
0,0,0,0,0,0,0,0,0,0,0,
0,0,0,0,0,0,0,0,0,0,0.