[layer]
type=Tile Layer 1
data=
0,0,21,1,4,0,16,6,1,0,0,
0,21,4,5,0,0,17,1,0,0,0,
8,21,1,1,1,4,1,5,1,0,0,
1,4,1,1,1,3,1,6,1,1,0,
1,1,3,1,1,3,1,21,1,4,1,
7,21,1,6,6,1,6,1,1,1,1,
4,16,21,1,3,1,16,1,0,0,0,
6,1,21,1,1,1,6,1,1,5,0,
1,5,4,21,21,1,1,3,1,0,0,
0,0,0,0,0,0,0,0,0,0,0,
0,0,0,0,0,0,0,0,0,0,0,
0,0,0,0,0,0,0,0,0,0,0,
0,0,0,0,0,0,0,0,0,0,0.
[layer]
type=Tile Layer 2
data=
0,0,0,85,85,0,42,85,85,0,0,
0,0,84,84,0,0,42,84,0,0,0,
0,0,112,112,112,112,112,112,112,0,0,
67,67,67,67,67,67,67,67,67,67,0,
67,67,67,67,67,67,67,0,67,67,67,
0,0,109,109,109,109,109,109,109,109,109,
72,36,0,72,72,72,36,72,0,0,0,
71,71,0,71,71,71,71,71,71,71,0,
70,70,70,0,0,70,70,70,70,0,0,
0,0,0,0,0,0,0,0,0,0,0,
0,0,0,0,0,0,0,0,0,0,0,
0,0,0,0,0,0,0,0,0,0,0,
0,0,0,0,0,0,0,0,0,0,0.