[layer]
type=Tile Layer 1
data=
1,1,1,1,0,1,1,1,1,1,1,
1,1,1,1,0,1,1,1,0,0,1,
1,1,1,1,1,1,1,1,1,0,1,
1,1,1,1,21,1,1,1,1,0,1,
1,1,1,1,0,1,1,1,1,21,1,
1,1,1,1,0,1,1,1,1,21,1,
1,0,21,0,0,1,1,1,1,0,0,
0,21,1,1,1,1,1,1,1,1,0,
0,21,1,1,1,1,1,0,0,0,0,
1,0,1,1,1,1,0,21,1,1,1,
0,0,1,1,1,1,1,21,1,1,1,
0,0,1,1,1,1,21,0,1,1,1,
1,0,1,1,1,1,21,1,1,1,1,
1,1,1,1,1,1,1,1,1,1,0,
1,1,21,1,1,0,1,1,1,1,1,
1,1,0,0,1,21,1,1,1,1,1,
1,1,1,0,1,21,1,1,1,1,1,
1,1,0,0,1,21,1,1,1,1,1,
1,1,1,0,0,0,0,0,0,1,1,
0,0,0,0,0,0,0,0,0,0,0,
0,0,0,0,0,0,0,0,0,0,0,
0,0,0,0,0,0,0,0,0,0,0,
0,0,0,0,0,0,0,0,0,0,0.
[layer]
type=Tile Layer 2
data=
60,60,60,60,0,60,60,60,60,60,60,
76,76,76,76,0,76,76,76,0,0,76,
60,60,60,60,60,60,60,60,60,0,60,
74,74,74,74,0,74,74,74,74,0,74,
73,73,73,73,0,73,73,73,73,0,73,
72,72,72,72,0,72,72,72,72,0,72,
82,0,0,0,0,82,82,82,82,0,0,
0,0,73,73,73,73,73,73,73,73,0,
0,0,79,79,79,79,79,0,0,0,0,
65,0,65,65,65,65,0,0,65,65,65,
0,0,64,64,64,64,64,0,64,64,64,
0,0,70,70,70,70,0,0,70,70,70,
50,0,50,50,50,50,0,50,50,50,50,
43,43,43,43,43,43,43,43,43,43,0,
49,49,0,49,49,0,49,49,49,49,49,
54,54,0,0,54,0,54,54,54,54,54,
48,48,48,0,48,0,48,48,48,48,48,
52,52,0,0,52,0,52,52,52,52,52,
58,58,58,0,0,0,0,0,0,58,58,
0,0,0,0,0,0,0,0,0,0,0,
0,0,0,0,0,0,0,0,0,0,0,
0,0,0,0,0,0,0,0,0,0,0,
0,0,0,0,0,0,0,0,0,0,0.