[layer]
type=Tile Layer 1
data=
0,0,1,4,1,21,1,6,1,0,0,
6,3,1,1,0,0,0,1,1,1,21,
1,1,1,21,1,1,1,0,3,3,0,
3,5,1,0,1,1,1,21,1,1,0,
5,1,6,1,0,21,0,1,1,1,0,
0,0,4,1,1,0,1,3,1,0,21,
0,21,0,4,1,6,1,1,0,0,0,
0,0,0,0,5,1,1,0,0,0,21,
0,21,0,1,4,1,5,1,0,0,0,
0,21,4,1,1,0,1,1,5,0,0,
0,1,3,6,0,21,0,1,1,1,1,
0,21,0,0,0,0,0,0,0,0,0,
0,0,0,0,0,0,0,0,0,0,0,
0,0,0,0,0,0,0,0,0,0,0,
0,0,0,0,0,0,0,0,0,0,0.
[layer]
type=Tile Layer 2
data=
0,0,61,61,61,0,61,61,61,0,0,
55,55,55,55,0,0,0,55,55,55,0,
49,49,49,0,49,49,49,0,49,49,0,
48,48,48,0,48,48,48,0,48,48,0,
47,47,47,47,0,0,0,47,47,47,0,
0,0,46,46,46,0,46,46,46,0,0,
0,0,0,46,46,46,46,46,0,0,0,
0,0,0,0,45,45,45,0,0,0,0,
0,0,0,44,44,44,44,44,0,0,0,
0,0,43,43,43,0,43,43,43,0,0,
0,42,42,42,0,0,0,42,42,42,42,
0,0,0,0,0,0,0,0,0,0,0,
0,0,0,0,0,0,0,0,0,0,0,
0,0,0,0,0,0,0,0,0,0,0,
0,0,0,0,0,0,0,0,0,0,0.