[layer]
type=Tile Layer 1
data=
1,1,0,1,0,0,1,0,1,0,1,
0,1,1,1,1,0,1,1,1,1,0,
0,0,0,1,1,0,0,1,1,0,0,
0,0,1,1,1,1,1,1,1,0,0,
0,1,21,0,0,0,0,0,21,1,0,
0,1,21,1,0,0,0,1,21,1,0,
0,1,21,0,1,1,1,0,21,1,0,
0,1,21,21,1,1,1,21,21,1,0,
0,0,1,1,1,1,1,1,1,0,0,
0,0,0,0,0,0,0,0,0,0,0,
0,0,0,0,0,0,0,0,0,0,0,
0,0,0,0,0,0,0,0,0,0,0,
0,0,0,0,0,0,0,0,0,0,0.
[layer]
type=Tile Layer 2
data=
75,75,0,75,0,0,75,0,75,0,75,
0,75,75,75,75,0,75,75,75,75,0,
0,0,0,68,68,0,0,68,68,0,0,
0,0,68,68,68,68,68,68,68,0,0,
0,68,0,0,0,0,0,0,0,68,0,
0,66,0,66,0,0,0,66,0,66,0,
0,64,0,0,64,64,64,0,0,64,0,
0,62,0,0,62,62,62,0,0,62,0,
0,0,59,59,59,59,59,59,59,0,0,
0,0,0,0,0,0,0,0,0,0,0,
0,0,0,0,0,0,0,0,0,0,0,
0,0,0,0,0,0,0,0,0,0,0,
0,0,0,0,0,0,0,0,0,0,0.