[layer]
type=Tile Layer 1
data=
1,0,1,1,3,0,4,1,1,0,1,
0,21,1,1,1,0,1,1,1,21,0,
0,0,5,1,6,0,5,1,6,0,0,
4,1,3,0,4,1,3,0,4,1,3,
1,1,1,0,1,1,1,0,1,1,1,
1,1,1,0,5,1,6,0,1,1,1,
23,0,4,1,3,1,4,1,3,0,23,
0,0,1,1,1,0,1,1,1,0,0,
0,0,5,1,6,0,5,1,6,0,0,
4,1,3,23,4,1,3,23,4,1,3,
1,1,1,0,1,1,1,0,1,1,1,
5,1,6,0,5,1,6,0,5,1,6,
0,0,4,1,3,1,4,1,3,0,0,
0,0,1,1,1,0,1,1,1,0,0,
0,0,5,1,6,21,5,1,6,0,0,
0,21,0,0,4,1,3,0,0,21,1,
1,0,0,0,1,1,1,0,0,0,1,
0,0,0,0,0,0,0,0,0,0,0,
0,0,0,0,0,0,0,0,0,0,0,
0,0,0,0,0,0,0,0,0,0,0,
0,0,0,0,0,0,0,0,0,0,0.
[layer]
type=Tile Layer 2
data=
105,0,105,105,105,0,105,105,105,0,105,
0,0,114,114,114,0,114,114,114,0,0,
0,0,112,112,112,0,112,112,112,0,0,
112,112,112,0,112,112,112,0,112,112,112,
103,103,103,0,103,103,103,0,103,103,103,
103,103,103,0,103,103,103,0,103,103,103,
0,0,103,103,103,103,103,103,103,0,0,
0,0,93,93,93,0,93,93,93,0,0,
0,0,93,93,93,0,93,93,93,0,0,
93,93,93,0,93,93,93,0,93,93,93,
82,82,82,0,82,82,82,0,82,82,82,
82,82,82,0,82,82,82,0,82,82,82,
0,0,82,82,82,82,82,82,82,0,0,
0,0,82,82,82,0,82,82,82,0,0,
0,0,82,82,82,0,82,82,82,0,0,
0,0,0,0,81,81,81,0,0,0,81,
80,0,0,0,80,80,80,0,0,0,80,
0,0,0,0,0,0,0,0,0,0,0,
0,0,0,0,0,0,0,0,0,0,0,
0,0,0,0,0,0,0,0,0,0,0,
0,0,0,0,0,0,0,0,0,0,0.