[layer]
type=Tile Layer 1
data=
8,1,1,1,1,21,0,0,0,1,0,
0,1,1,1,1,1,1,21,1,1,0,
0,1,1,1,1,1,21,0,1,1,0,
0,1,1,1,1,21,7,0,17,17,0,
0,1,1,1,1,21,0,0,1,1,0,
0,1,1,17,17,21,0,0,1,1,0,
0,16,1,1,1,21,0,0,16,1,0,
0,1,1,1,21,0,0,0,1,1,0,
0,1,1,1,21,0,0,0,1,1,0,
0,1,1,1,21,0,0,0,1,1,0,
0,16,1,1,21,0,0,0,1,16,0,
0,1,1,21,0,0,0,0,17,1,0,
0,1,1,21,0,0,0,0,1,1,0,
7,17,1,21,0,0,0,0,1,1,0,
0,1,1,21,0,0,0,0,1,1,0,
0,1,21,0,0,0,7,0,0,1,0,
0,21,1,16,1,1,1,1,1,0,0,
0,0,0,0,0,0,0,0,0,0,0,
0,0,0,0,0,0,0,0,0,0,0,
0,0,0,0,0,0,0,0,0,0,0,
0,0,0,0,0,0,0,0,0,0,0.
[layer]
type=Tile Layer 2
data=
0,169,169,169,169,0,0,0,0,169,0,
0,122,122,122,122,122,122,0,122,122,0,
0,121,121,121,121,121,0,0,121,121,0,
0,178,178,178,178,0,0,0,89,89,0,
0,109,109,109,109,0,0,0,109,109,0,
0,108,108,54,54,0,0,0,108,108,0,
0,53,107,107,107,0,0,0,53,107,0,
0,97,97,97,0,0,0,0,97,97,0,
0,96,96,96,0,0,0,0,96,96,0,
0,95,95,95,0,0,0,0,95,95,0,
0,42,85,85,0,0,0,0,85,42,0,
0,84,84,0,0,0,0,0,42,84,0,
0,83,83,0,0,0,0,0,83,83,0,
0,61,123,0,0,0,0,0,123,123,0,
0,81,81,0,0,0,0,0,81,81,0,
0,120,0,0,0,0,0,0,0,120,0,
0,0,79,39,79,79,79,79,79,0,0,
0,0,0,0,0,0,0,0,0,0,0,
0,0,0,0,0,0,0,0,0,0,0,
0,0,0,0,0,0,0,0,0,0,0,
0,0,0,0,0,0,0,0,0,0,0.