[layer]
type=Tile Layer 1
data=
0,1,1,1,1,1,1,1,1,1,0,
0,1,0,0,0,1,0,0,0,1,0,
1,1,1,0,1,1,1,0,1,1,1,
1,0,1,0,1,1,1,0,1,0,1,
1,21,1,0,1,1,1,0,1,21,1,
1,21,1,0,1,1,1,0,1,21,1,
1,21,1,0,1,1,1,0,1,21,1,
1,21,1,0,0,0,0,0,1,21,1,
1,21,1,0,0,0,0,0,1,21,1,
0,0,0,0,0,0,0,0,0,0,0,
0,0,0,0,0,0,0,0,0,0,0,
0,0,0,0,0,0,0,0,0,0,0,
0,0,0,0,0,0,0,0,0,0,0.
[layer]
type=Tile Layer 2
data=
0,85,85,85,85,85,85,85,85,85,0,
0,85,0,0,0,85,0,0,0,85,0,
77,77,77,0,77,77,77,0,77,77,77,
77,0,77,0,77,77,77,0,77,0,77,
77,0,77,0,77,77,77,0,77,0,77,
75,0,75,0,75,75,75,0,75,0,75,
73,0,73,0,73,73,73,0,73,0,73,
71,0,71,0,0,0,0,0,71,0,71,
69,0,69,0,0,0,0,0,69,0,69,
0,0,0,0,0,0,0,0,0,0,0,
0,0,0,0,0,0,0,0,0,0,0,
0,0,0,0,0,0,0,0,0,0,0,
0,0,0,0,0,0,0,0,0,0,0.