[layer]
type=Tile Layer 1
data=
1,1,1,1,1,1,1,1,1,1,0,
1,0,2,1,2,2,1,24,2,2,1,
2,0,0,2,2,0,21,8,0,0,0,
1,2,2,1,2,0,1,1,2,2,1,
1,0,1,0,0,0,1,0,0,0,0,
0,1,1,2,2,2,2,1,2,2,1,
2,1,0,2,2,2,2,1,1,2,1,
2,0,1,2,2,2,1,1,1,2,1,
0,21,2,0,2,0,8,0,0,0,2,
2,2,1,2,0,2,2,1,1,2,1,
1,2,1,2,2,2,2,21,2,1,1,
0,21,0,0,2,1,0,0,2,24,0,
1,1,1,0,1,1,1,21,1,0,1,
0,0,2,24,0,0,2,2,2,0,1,
1,0,1,1,1,24,1,1,1,21,1,
1,1,1,1,0,1,1,1,1,1,1,
2,2,1,2,2,1,2,2,1,0,1,
2,1,1,8,2,1,2,21,2,2,1,
0,0,0,0,2,21,0,8,2,0,0,
1,1,2,2,2,7,2,2,2,21,1,
21,0,0,0,0,24,1,1,1,0,0,
1,1,2,2,2,1,2,21,2,2,1,
2,0,0,0,0,0,21,0,0,0,2,
2,24,1,1,2,1,2,2,2,21,1,
0,21,2,2,2,0,0,24,0,0,2,
2,2,2,2,2,21,2,1,1,1,1,
2,2,0,1,1,2,2,2,2,1,1,
2,0,0,0,0,0,2,0,21,0,0,
1,21,1,1,1,0,1,7,1,1,1,
0,0,2,2,2,0,0,0,2,24,21,
2,1,2,21,2,1,2,1,2,24,1,
0,0,0,0,0,0,0,21,2,24,2,
2,2,2,2,2,8,2,0,1,21,1,
2,21,0,0,0,0,2,0,2,24,2,
1,21,1,1,1,1,1,0,1,0,1,
1,2,2,1,2,1,2,0,2,2,1,
2,2,1,7,2,21,2,2,1,1,1,
0,0,2,0,2,0,21,0,0,0,0,
1,21,1,0,2,2,2,1,2,1,1,
0,8,2,21,0,2,2,0,0,0,2,
1,1,1,1,1,1,1,21,1,0,1,
1,0,0,0,0,0,0,0,1,21,0,
1,21,1,1,1,1,1,1,1,1,1,
1,21,0,0,1,0,0,0,0,0,1,
1,1,1,0,1,0,1,21,1,0,1,
1,0,7,0,1,1,1,0,1,21,1,
2,21,1,2,2,2,1,0,2,0,1,
0,0,1,21,0,0,0,0,1,0,1,
1,1,1,7,1,1,1,1,1,0,1,
1,8,0,0,1,1,1,0,21,0,0,
1,21,1,1,1,0,1,8,1,1,1,
0,0,1,1,0,0,0,21,1,0,0,
1,0,1,1,1,1,1,21,1,0,1,
2,0,0,0,21,0,2,0,2,0,2,
1,2,2,2,2,0,2,21,2,0,1,
1,1,1,0,0,0,1,0,1,21,1,
1,0,1,21,1,1,1,0,1,0,1,
1,0,1,0,1,1,1,21,1,1,1,
1,8,1,0,0,0,1,21,0,1,1,
2,0,2,1,1,21,2,1,2,2,1,
2,21,0,2,2,0,0,0,0,0,2,
2,21,2,2,1,1,2,1,2,0,1,
0,0,1,0,0,0,0,0,21,0,1,
1,1,1,24,1,1,1,1,1,21,1,
0,0,1,0,1,0,21,1,1,0,1,
1,0,1,0,1,0,1,1,1,24,1,
1,1,1,1,1,1,0,1,1,1,1,
1,1,1,1,1,0,1,1,1,1,1,
1,1,1,1,1,1,1,0,1,1,1,
1,21,1,1,0,0,1,0,0,0,0,
1,21,1,1,1,0,1,0,1,1,1,
1,0,21,0,0,0,1,0,1,0,0,
2,2,2,1,2,0,2,0,2,21,1,
0,0,2,0,0,21,2,0,2,0,0,
1,0,1,21,1,1,1,0,1,1,1,
1,0,0,21,1,1,1,0,1,1,0,
0,0,0,0,0,0,0,0,0,0,0,
0,0,0,0,0,0,0,0,0,0,0,
0,0,0,0,0,0,0,0,0,0,0,
0,0,0,0,0,0,0,0,0,0,0.
[layer]
type=Tile Layer 2
data=
199,199,199,199,199,199,199,199,199,199,0,
298,0,298,298,298,298,298,0,298,298,298,
298,0,0,298,298,0,0,0,0,0,0,
182,182,182,182,182,0,182,182,182,182,182,
182,0,182,0,0,0,182,0,0,0,0,
0,182,182,182,182,182,182,182,182,182,182,
198,198,0,198,198,198,198,198,198,198,198,
198,0,198,198,198,198,198,198,198,198,198,
0,0,297,0,297,0,0,0,0,0,297,
181,181,181,181,0,181,181,181,181,181,181,
181,181,181,181,181,181,181,0,181,181,181,
0,0,0,0,270,270,0,0,270,0,0,
194,194,194,0,194,194,194,0,194,0,194,
0,0,289,0,0,0,289,289,289,0,289,
289,0,289,289,289,0,289,289,289,0,289,
177,177,177,177,0,177,177,177,177,177,177,
177,177,177,177,177,177,177,177,177,0,177,
265,265,265,0,265,265,265,0,265,265,265,
0,0,0,0,286,0,0,0,286,0,0,
285,285,285,285,285,0,285,285,285,0,285,
0,0,0,0,0,0,282,282,282,0,0,
172,172,172,172,172,172,172,0,172,172,172,
171,0,0,0,0,0,0,0,0,0,171,
255,0,255,255,255,255,255,255,255,0,255,
0,0,276,276,276,0,0,0,0,0,276,
182,182,182,182,182,0,182,182,182,182,182,
181,181,0,181,181,181,181,181,181,181,181,
167,0,0,0,0,0,167,0,0,0,0,
249,0,249,249,249,0,249,0,249,249,249,
0,0,247,247,247,0,0,0,247,0,0,
267,267,267,0,267,267,267,267,267,0,267,
0,0,0,0,0,0,0,0,264,0,264,
262,262,262,262,262,0,262,0,262,0,262,
240,0,0,0,0,0,240,0,240,0,240,
159,0,159,159,159,159,159,0,159,0,159,
158,158,158,158,158,158,158,0,158,158,158,
258,258,258,0,258,0,258,258,258,258,258,
0,0,170,0,170,0,0,0,0,0,0,
169,0,169,0,169,169,169,169,169,169,169,
0,0,232,0,0,232,232,0,0,0,232,
154,154,154,154,154,154,154,0,154,0,154,
153,0,0,0,0,0,0,0,153,0,0,
164,0,164,164,164,164,164,164,164,164,164,
163,0,0,0,163,0,0,0,0,0,163,
162,162,162,0,162,0,162,0,162,0,162,
222,0,0,0,222,222,222,0,222,0,222,
147,0,147,147,147,147,147,0,147,0,147,
0,0,146,0,0,0,0,0,146,0,146,
235,235,235,0,235,235,235,235,235,0,235,
235,0,0,0,235,235,235,0,0,0,0,
234,0,234,234,234,0,234,0,234,234,234,
0,0,143,143,0,0,0,0,143,0,0,
142,0,142,142,142,142,142,0,142,0,142,
140,0,0,0,0,0,140,0,140,0,140,
151,151,151,151,151,0,151,0,151,0,151,
150,150,150,0,0,0,150,0,150,0,150,
149,0,149,0,149,149,149,0,149,0,149,
136,0,136,0,136,136,136,0,136,136,136,
202,0,202,0,0,0,202,0,0,202,202,
134,0,134,134,134,0,134,134,134,134,134,
144,0,0,144,144,0,0,0,0,0,144,
143,0,143,143,143,143,143,143,143,0,143,
0,0,142,0,0,0,0,0,0,0,142,
193,193,193,0,193,193,193,193,193,0,193,
0,0,128,0,128,0,0,128,128,0,128,
190,0,190,0,190,0,190,190,190,0,190,
117,117,117,117,117,117,0,117,117,117,117,
117,117,117,117,117,0,117,117,117,117,117,
117,117,117,117,117,117,117,0,117,117,117,
106,0,106,106,0,0,106,0,0,0,0,
105,0,105,105,105,0,105,0,105,105,105,
104,0,0,0,0,0,104,0,104,0,0,
103,103,103,103,103,0,103,0,103,0,103,
0,0,102,0,0,0,102,0,102,0,0,
101,0,101,0,101,101,101,0,101,101,101,
100,0,0,0,100,100,100,0,100,100,0,
0,0,0,0,0,0,0,0,0,0,0,
0,0,0,0,0,0,0,0,0,0,0,
0,0,0,0,0,0,0,0,0,0,0,
0,0,0,0,0,0,0,0,0,0,0.