[layer]
type=Tile Layer 1
data=
0,0,21,1,1,1,1,1,21,24,0,
0,0,21,1,21,0,21,1,21,0,0,
0,0,21,1,0,2,0,1,21,0,0,
0,0,21,1,0,1,0,1,21,0,0,
0,1,1,1,0,1,0,1,1,1,0,
8,1,1,1,0,0,0,1,2,2,0,
0,1,2,1,2,1,1,1,1,1,0,
0,1,1,0,0,0,0,0,1,1,0,
0,1,1,1,1,1,1,1,1,1,0,
0,0,0,0,0,0,0,0,0,0,0,
0,0,0,0,0,0,0,0,0,0,0,
0,0,0,0,0,0,0,0,0,0,0,
0,0,0,0,0,0,0,0,0,0,0.
[layer]
type=Tile Layer 2
data=
0,0,0,112,112,112,112,112,0,0,0,
0,0,0,73,0,0,0,73,0,0,0,
0,0,0,62,0,62,0,62,0,0,0,
0,0,0,60,0,60,0,60,0,0,0,
0,59,59,59,0,59,0,59,59,59,0,
0,88,88,88,0,0,0,88,88,88,0,
0,53,53,53,53,53,53,53,53,53,0,
0,59,59,0,0,0,0,0,59,59,0,
0,53,53,53,53,53,53,53,53,53,0,
0,0,0,0,0,0,0,0,0,0,0,
0,0,0,0,0,0,0,0,0,0,0,
0,0,0,0,0,0,0,0,0,0,0,
0,0,0,0,0,0,0,0,0,0,0.