[layer]
type=Tile Layer 1
data=
1,1,1,0,4,1,1,1,1,1,0,
1,9,1,0,1,1,1,1,1,1,0,
0,1,1,0,1,1,0,0,0,0,0,
0,0,0,0,1,0,0,1,1,1,1,
0,1,1,0,1,0,0,1,1,9,1,
0,1,0,0,0,0,0,1,1,1,1,
0,1,0,5,1,1,1,1,1,9,1,
0,1,3,0,1,1,1,1,1,1,1,
0,0,0,0,0,0,0,1,1,1,0,
0,0,0,0,0,0,0,0,0,0,0,
0,0,0,0,0,0,0,0,0,0,0.
[layer]
type=Tile Layer 2
data=
33,24,33,0,33,24,24,24,24,33,0,
33,24,33,0,33,24,24,24,24,33,0,
0,42,42,0,42,42,0,0,0,0,0,
0,0,0,0,60,0,0,42,30,30,42,
0,42,42,0,60,0,0,42,30,30,42,
0,60,0,0,0,0,0,42,30,30,42,
0,48,0,33,24,24,24,24,24,24,33,
0,60,60,0,60,40,40,40,40,40,60,
0,0,0,0,0,0,0,42,30,42,0,
0,0,0,0,0,0,0,0,0,0,0,
0,0,0,0,0,0,0,0,0,0,0.