[layer]
type=Tile Layer 1
data=
1,1,1,1,1,1,21,0,21,1,1,
0,0,1,0,0,0,1,1,1,0,0,
0,1,0,1,0,1,1,1,1,1,0,
0,1,0,1,0,1,1,1,1,1,0,
1,0,0,1,0,0,1,21,1,0,0,
1,0,0,1,0,1,21,1,21,1,0,
1,0,1,0,0,1,1,21,1,1,0,
1,0,0,0,1,1,21,1,21,1,1,
0,1,1,1,0,0,1,21,1,0,0,
0,0,0,0,0,0,0,0,0,0,0,
0,0,0,0,0,0,0,0,0,0,0,
0,0,0,0,0,0,0,0,0,0,0,
0,0,0,0,0,0,0,0,0,0,0.
[layer]
type=Tile Layer 2
data=
55,55,55,55,55,55,0,0,0,55,55,
0,0,59,0,0,0,59,59,59,0,0,
0,53,0,53,0,53,53,53,53,53,0,
0,53,0,53,0,53,53,53,53,53,0,
53,0,0,53,0,0,53,0,53,0,0,
52,0,0,52,0,52,0,52,0,52,0,
50,0,50,0,0,50,50,0,50,50,0,
49,0,0,0,49,49,0,49,0,49,49,
0,47,47,47,0,0,47,0,47,0,0,
0,0,0,0,0,0,0,0,0,0,0,
0,0,0,0,0,0,0,0,0,0,0,
0,0,0,0,0,0,0,0,0,0,0,
0,0,0,0,0,0,0,0,0,0,0.