[layer]
type=Tile Layer 1
data=
1,0,1,1,1,1,1,1,1,1,1,
1,1,1,1,0,1,1,21,0,1,1,
1,1,1,0,21,1,1,0,0,0,1,
1,1,1,21,0,1,1,1,1,0,0,
1,1,1,1,0,1,1,1,1,0,0,
1,1,1,1,0,1,1,1,1,0,21,
1,1,0,0,0,1,1,1,1,0,0,
1,0,0,1,1,1,1,1,1,0,21,
1,21,0,1,1,1,1,1,1,1,0,
1,0,21,1,1,1,1,1,1,1,0,
1,1,1,1,0,1,1,1,1,1,1,
0,1,1,1,1,1,1,1,1,0,21,
0,0,1,1,1,1,1,1,0,0,21,
1,0,0,21,1,1,0,0,0,1,1,
1,1,1,0,0,21,0,1,1,1,1,
0,0,0,0,0,0,0,0,0,0,0,
0,0,0,0,0,0,0,0,0,0,0,
0,0,0,0,0,0,0,0,0,0,0,
0,0,0,0,0,0,0,0,0,0,0.
[layer]
type=Tile Layer 2
data=
53,0,53,53,53,53,53,53,53,53,53,
67,67,67,67,0,67,67,0,0,67,67,
69,69,69,0,0,69,69,0,0,0,69,
67,67,67,0,0,67,67,67,67,0,0,
60,60,60,60,0,60,60,60,60,0,0,
55,55,55,55,0,55,55,55,55,0,0,
60,60,0,0,0,60,60,60,60,0,0,
60,0,0,60,60,60,60,60,60,0,0,
48,0,0,48,48,48,48,48,48,48,0,
47,0,0,47,47,47,47,47,47,47,0,
36,36,36,36,0,36,36,36,36,36,36,
0,46,46,46,46,46,46,46,46,0,0,
0,0,50,50,50,50,50,50,0,0,0,
49,0,0,0,49,49,0,0,0,49,49,
48,48,48,0,0,0,0,48,48,48,48,
0,0,0,0,0,0,0,0,0,0,0,
0,0,0,0,0,0,0,0,0,0,0,
0,0,0,0,0,0,0,0,0,0,0,
0,0,0,0,0,0,0,0,0,0,0.