[layer]
type=Tile Layer 1
data=
1,1,0,1,1,1,1,1,1,1,1,
0,1,0,0,0,0,0,1,0,1,0,
0,1,1,1,1,1,1,1,21,1,0,
21,1,0,0,1,1,0,0,0,0,0,
0,1,21,1,1,1,0,1,1,1,1,
0,1,0,0,0,1,0,1,21,0,0,
1,1,1,1,0,1,0,1,21,1,1,
21,0,0,0,0,1,0,1,0,0,0,
1,1,0,1,21,1,0,1,1,1,0,
0,0,0,1,1,1,0,1,21,0,0,
1,1,1,1,1,1,21,1,0,1,1,
0,0,0,1,0,0,21,1,0,0,0,
1,1,1,1,1,1,1,1,1,1,0,
0,0,0,1,0,1,0,21,0,1,0,
0,1,1,1,0,1,21,1,1,1,0,
0,0,0,0,0,0,0,0,0,0,0,
0,0,0,0,0,0,0,0,0,0,0,
0,0,0,0,0,0,0,0,0,0,0,
0,0,0,0,0,0,0,0,0,0,0.
[layer]
type=Tile Layer 2
data=
53,53,0,53,53,53,53,53,53,53,53,
0,76,0,0,0,0,0,76,0,76,0,
0,62,62,62,62,62,62,62,0,62,0,
0,69,0,0,69,69,0,0,0,0,0,
0,61,0,61,61,61,0,61,61,61,61,
0,61,0,0,0,61,0,61,0,0,0,
54,54,54,54,0,54,0,54,0,54,54,
0,0,0,0,0,59,0,59,0,0,0,
52,52,0,52,0,52,0,52,52,52,0,
0,0,0,51,51,51,0,51,0,0,0,
40,40,40,40,40,40,0,40,0,40,40,
0,0,0,49,0,0,0,49,0,0,0,
34,34,34,34,34,34,34,34,34,34,0,
0,0,0,48,0,48,0,0,0,48,0,
0,47,47,47,0,47,0,47,47,47,0,
0,0,0,0,0,0,0,0,0,0,0,
0,0,0,0,0,0,0,0,0,0,0,
0,0,0,0,0,0,0,0,0,0,0,
0,0,0,0,0,0,0,0,0,0,0.