[layer]
type=Tile Layer 1
data=
1,1,1,1,1,1,1,1,1,0,1,
21,0,1,1,1,1,1,1,1,0,1,
1,0,21,0,1,1,1,1,1,0,0,
1,0,1,1,1,1,1,1,1,1,1,
1,1,1,0,0,1,0,8,0,21,1,
1,1,1,0,21,1,0,1,1,1,1,
1,1,1,1,0,1,0,1,1,1,1,
1,1,1,1,21,1,8,1,1,1,1,
1,0,0,0,0,1,0,21,1,1,1,
1,7,0,1,1,1,1,21,0,0,1,
1,1,24,1,1,1,1,1,1,0,21,
1,1,0,1,1,1,1,21,0,0,0,
1,1,21,1,1,1,0,0,1,1,1,
1,1,0,0,1,1,0,1,1,1,1,
1,1,1,1,1,0,1,1,1,1,1,
0,0,0,0,0,0,0,0,0,0,0,
0,0,0,0,0,0,0,0,0,0,0,
0,0,0,0,0,0,0,0,0,0,0,
0,0,0,0,0,0,0,0,0,0,0.
[layer]
type=Tile Layer 2
data=
52,52,52,52,52,52,52,52,52,0,52,
0,0,66,66,66,66,66,66,66,0,66,
66,0,0,0,66,66,66,66,66,0,0,
46,0,46,46,46,46,46,46,46,46,46,
97,97,97,0,0,97,0,0,0,0,97,
53,53,53,0,0,53,0,53,53,53,53,
46,46,46,46,0,46,0,46,46,46,46,
69,69,69,69,0,69,0,69,69,69,69,
51,0,0,0,0,51,0,0,51,51,51,
75,0,0,75,75,75,75,0,0,0,75,
66,66,0,66,66,66,66,66,66,0,0,
48,48,0,48,48,48,48,0,0,0,0,
42,42,0,42,42,42,0,0,42,42,42,
42,42,0,0,42,42,0,42,42,42,42,
33,33,33,33,33,0,33,33,33,33,33,
0,0,0,0,0,0,0,0,0,0,0,
0,0,0,0,0,0,0,0,0,0,0,
0,0,0,0,0,0,0,0,0,0,0,
0,0,0,0,0,0,0,0,0,0,0.