[layer]
type=Tile Layer 1
data=
1,1,1,1,1,21,1,1,1,1,1,
1,1,0,4,1,21,1,3,0,1,1,
1,0,1,1,0,0,21,1,1,0,1,
1,4,1,0,0,0,0,21,1,3,1,
1,1,0,0,1,1,1,0,21,1,1,
1,1,0,0,1,1,1,0,21,1,1,
1,5,1,3,0,0,21,4,1,6,1,
1,0,5,1,0,0,21,1,6,0,1,
1,1,1,1,0,1,21,1,1,1,1,
0,0,0,0,0,0,0,0,0,0,0,
0,0,0,0,0,0,0,0,0,0,0,
0,0,0,0,0,0,0,0,0,0,0,
0,0,0,0,0,0,0,0,0,0,0.
[layer]
type=Tile Layer 2
data=
50,50,50,50,50,0,50,50,50,50,50,
61,61,0,61,61,0,61,61,0,61,61,
54,0,54,54,0,0,0,54,54,0,54,
53,53,53,0,0,0,0,0,53,53,53,
52,52,0,0,52,52,52,0,0,52,52,
51,51,0,0,51,51,51,0,0,51,51,
50,50,50,50,0,0,0,50,50,50,50,
49,0,49,49,0,0,0,49,49,0,49,
43,43,43,43,0,43,0,43,43,43,43,
0,0,0,0,0,0,0,0,0,0,0,
0,0,0,0,0,0,0,0,0,0,0,
0,0,0,0,0,0,0,0,0,0,0,
0,0,0,0,0,0,0,0,0,0,0.