[layer]
type=Tile Layer 1
data=
1,1,2,0,1,2,2,2,2,1,1,
18,2,2,18,2,16,16,1,0,18,1,
2,17,19,17,2,21,0,19,19,19,1,
18,18,16,2,18,18,21,24,16,2,1,
1,17,19,2,19,19,19,0,0,19,1,
18,2,2,1,18,16,16,18,0,7,0,
17,1,2,2,17,19,19,17,2,19,0,
1,1,18,18,18,18,1,18,18,0,1,
17,2,17,17,2,2,19,19,19,21,1,
18,2,16,16,16,18,2,18,2,21,1,
17,19,2,2,19,1,1,19,19,0,1,
18,2,16,16,2,1,18,18,7,21,0,
17,17,17,19,2,2,2,19,0,21,0,
2,16,18,1,18,2,18,16,24,0,21,
1,2,19,1,19,2,17,17,19,1,21,
18,16,2,18,18,18,1,0,24,0,21,
2,17,19,2,17,19,19,8,21,19,1,
16,16,16,1,16,16,0,21,8,16,1,
0,17,2,1,19,17,17,19,19,2,1,
16,2,18,18,1,2,18,16,21,18,1,
2,17,19,1,19,1,19,19,21,19,1,
16,18,18,18,16,18,2,2,21,0,1,
1,1,1,1,1,1,1,1,8,0,21,
16,0,2,2,16,16,18,2,18,16,1,
19,2,2,1,2,1,19,17,17,17,21,
16,16,1,16,1,16,16,1,0,21,0,
2,17,19,1,19,19,19,19,0,21,1,
1,2,2,2,2,2,2,1,0,21,1,
17,17,17,1,0,1,17,17,1,17,1,
18,18,16,2,18,1,1,18,21,18,1,
17,17,1,1,17,17,17,17,0,21,1,
2,2,1,2,1,2,1,2,1,21,0,
19,17,1,2,1,2,17,1,19,19,21,
18,2,1,16,2,2,16,16,18,0,21,
19,2,2,19,19,17,17,2,17,21,1,
1,1,1,1,1,1,1,1,1,7,0,
1,17,17,17,1,1,1,17,17,21,0,
16,1,16,1,16,16,16,1,16,21,1,
1,2,2,1,1,1,2,2,1,2,0,
18,16,1,1,16,2,18,18,2,21,0,
17,17,1,17,17,1,17,1,1,0,21,
1,1,1,1,1,1,1,1,1,21,0,
19,1,19,1,1,2,19,19,17,0,21,
1,1,1,1,1,0,0,21,0,0,0,
1,1,1,1,1,0,0,21,1,1,1,
1,2,2,2,2,1,2,21,0,0,0,
1,1,1,1,1,1,1,1,0,0,0,
16,1,16,16,1,16,16,1,21,16,1,
1,1,0,0,21,24,0,1,1,1,1,
1,1,1,1,1,1,21,0,0,0,1,
17,17,17,1,1,17,17,17,1,21,1,
1,1,1,1,1,1,1,1,1,21,24,
19,1,19,1,2,19,2,1,17,17,21,
1,1,1,1,1,1,1,1,1,1,21,
1,1,1,1,1,1,1,1,0,0,21,
1,1,1,1,1,1,1,1,0,21,0,
1,2,2,2,1,2,2,21,0,0,0,
1,1,1,1,1,1,1,21,1,1,1,
1,1,1,1,1,1,1,1,1,0,1,
1,1,1,1,1,1,1,1,21,1,1,
1,1,21,1,1,1,1,1,1,1,1,
1,1,21,0,0,1,1,1,1,1,1,
1,1,1,1,21,0,1,1,1,1,1,
1,1,1,1,1,0,21,1,1,1,1,
1,1,1,1,1,1,0,0,0,0,21,
2,1,2,1,2,1,2,1,2,21,0,
1,1,1,1,1,1,1,0,0,21,1,
2,1,2,2,1,2,2,0,21,2,1,
1,1,1,1,1,1,1,1,21,1,1,
1,1,1,1,1,1,1,0,21,0,1,
1,2,2,2,2,1,1,2,2,21,1,
1,1,1,1,1,1,1,1,1,21,1,
1,1,1,1,1,1,1,1,1,7,21,
16,16,1,16,16,1,16,1,1,1,21,
1,2,1,2,2,1,1,2,2,1,21,
1,1,1,1,1,1,1,1,1,1,21,
0,0,0,0,0,0,0,0,0,0,0,
0,0,0,0,0,0,0,0,0,0,0,
0,0,0,0,0,0,0,0,0,0,0,
0,0,0,0,0,0,0,0,0,0,0.
[layer]
type=Tile Layer 2
data=
139,139,139,0,139,139,139,139,139,139,139,
139,139,139,139,139,69,69,139,0,139,139,
158,79,158,79,158,0,0,158,158,158,158,
216,216,108,216,216,216,0,0,108,216,216,
144,72,144,144,144,144,144,0,0,144,144,
243,243,243,243,243,121,121,243,0,0,0,
69,138,138,138,69,138,138,69,138,138,0,
138,138,138,138,138,138,138,138,138,0,138,
69,138,69,69,138,138,138,138,138,0,138,
126,126,63,63,63,126,126,126,126,0,126,
62,125,125,125,125,125,125,125,125,0,125,
240,240,120,120,240,240,240,240,0,0,0,
86,86,86,173,173,173,173,173,0,0,0,
258,129,258,258,258,258,258,129,0,0,0,
133,133,133,133,133,133,66,66,133,133,0,
259,129,259,259,259,259,259,0,0,0,0,
207,103,207,207,103,207,207,0,0,207,207,
114,114,114,229,114,114,0,0,0,114,229,
0,65,130,130,130,65,65,130,130,130,130,
65,130,130,130,130,130,130,65,0,130,130,
130,65,130,130,130,130,130,130,0,130,130,
67,134,134,134,67,134,134,134,0,0,134,
225,225,225,225,225,225,225,225,0,0,0,
58,0,116,116,58,58,116,116,116,58,116,
126,126,126,126,126,126,126,63,63,63,0,
80,80,161,80,161,80,80,161,0,0,0,
143,71,143,143,143,143,143,143,0,0,143,
130,130,130,130,130,130,130,130,0,0,130,
57,57,57,114,0,114,57,57,114,57,114,
114,114,57,114,114,114,114,114,0,114,114,
69,69,139,139,69,69,69,69,0,0,139,
138,138,138,138,138,138,138,138,138,0,0,
121,60,121,121,121,121,60,121,121,121,0,
126,126,126,63,126,126,63,63,126,0,0,
109,109,109,109,109,54,54,109,54,0,109,
184,184,184,184,184,184,184,184,184,0,0,
134,67,67,67,134,134,134,67,67,0,0,
59,118,59,118,59,59,59,118,59,0,118,
116,116,116,116,116,116,116,116,116,116,0,
122,61,122,122,61,122,122,122,122,0,0,
60,60,121,60,60,121,60,121,121,0,0,
120,120,120,120,120,120,120,120,120,0,0,
130,130,130,130,130,130,130,130,65,0,0,
161,161,161,161,161,0,0,0,0,0,0,
144,144,144,144,144,0,0,0,144,144,144,
145,145,145,145,145,145,145,0,0,0,0,
130,130,130,130,130,130,130,130,0,0,0,
50,101,50,50,101,50,50,101,0,50,101,
234,234,0,0,0,0,0,234,234,234,234,
155,155,155,155,155,155,0,0,0,0,155,
54,54,54,108,108,54,54,54,108,0,108,
168,168,168,168,168,168,168,168,168,0,0,
98,98,98,98,98,98,98,98,49,49,0,
97,97,97,97,97,97,97,97,97,97,0,
133,133,133,133,133,133,133,133,0,0,0,
133,133,133,133,133,133,133,133,0,0,0,
146,146,146,146,146,146,146,0,0,0,0,
94,94,94,94,94,94,94,0,94,94,94,
93,93,93,93,93,93,93,93,93,0,93,
93,93,93,93,93,93,93,93,0,93,93,
101,101,0,101,101,101,101,101,101,101,101,
127,127,0,0,0,127,127,127,127,127,127,
113,113,113,113,0,0,113,113,113,113,113,
103,103,103,103,103,0,0,103,103,103,103,
127,127,127,127,127,127,0,0,0,0,0,
100,100,100,100,100,100,100,100,100,0,0,
103,103,103,103,103,103,103,0,0,0,103,
91,91,91,91,91,91,91,0,0,91,91,
79,79,79,79,79,79,79,79,0,79,79,
90,90,90,90,90,90,90,0,0,0,90,
70,70,70,70,70,70,70,70,70,0,70,
69,69,69,69,69,69,69,69,69,0,69,
117,117,117,117,117,117,117,117,117,0,0,
34,34,68,34,34,68,34,68,68,68,0,
67,67,67,67,67,67,67,67,67,67,0,
67,67,67,67,67,67,67,67,67,67,0,
0,0,0,0,0,0,0,0,0,0,0,
0,0,0,0,0,0,0,0,0,0,0,
0,0,0,0,0,0,0,0,0,0,0,
0,0,0,0,0,0,0,0,0,0,0.