[layer]
type=Tile Layer 1
data=
0,0,21,1,0,0,0,0,0,1,0,
1,1,7,1,1,1,0,1,21,1,0,
0,0,0,2,0,0,0,1,0,0,21,
1,1,1,1,21,1,1,2,2,1,0,
0,1,1,0,0,0,0,1,2,1,0,
21,1,1,1,1,1,0,1,0,1,1,
21,0,0,1,0,0,0,1,0,1,0,
1,1,0,1,0,1,1,1,7,1,21,
0,0,8,1,0,1,1,0,21,0,0,
1,1,1,1,21,1,1,1,1,1,0,
0,1,1,0,0,0,0,0,21,1,0,
0,1,1,1,1,1,1,1,0,1,21,
0,1,1,1,1,1,1,1,1,1,1,
0,0,0,0,0,0,0,0,0,0,0,
0,0,0,0,0,0,0,0,0,0,0,
0,0,0,0,0,0,0,0,0,0,0,
0,0,0,0,0,0,0,0,0,0,0.
[layer]
type=Tile Layer 2
data=
0,0,0,69,0,0,0,0,0,69,0,
102,102,0,102,102,102,0,102,0,102,0,
0,0,0,66,0,0,0,66,0,0,0,
48,48,48,48,0,48,48,48,48,48,0,
0,59,59,0,0,0,0,59,59,59,0,
0,53,53,53,53,53,0,53,0,53,53,
0,0,0,52,0,0,0,52,0,52,0,
76,76,0,76,0,76,76,76,0,76,0,
0,0,0,75,0,75,75,0,0,0,0,
39,39,39,39,0,39,39,39,39,39,0,
0,48,48,0,0,0,0,0,0,48,0,
0,42,42,42,42,42,42,42,0,42,0,
0,33,33,33,33,33,33,33,33,33,33,
0,0,0,0,0,0,0,0,0,0,0,
0,0,0,0,0,0,0,0,0,0,0,
0,0,0,0,0,0,0,0,0,0,0,
0,0,0,0,0,0,0,0,0,0,0.