[layer]
type=Tile Layer 1
data=
0,0,0,0,0,0,0,0,0,1,0,
0,0,1,1,1,21,0,0,1,1,1,
0,1,0,0,0,1,21,0,1,1,1,
0,1,0,0,0,1,21,0,0,1,0,
1,1,1,1,1,1,1,21,0,1,0,
1,1,1,1,1,1,1,21,1,1,0,
1,1,1,1,1,1,1,21,0,1,0,
0,1,1,1,1,1,21,0,1,1,0,
0,0,0,0,0,0,0,0,0,0,0,
0,0,0,0,0,0,0,0,0,0,0,
0,0,0,0,0,0,0,0,0,0,0,
0,0,0,0,0,0,0,0,0,0,0,
0,0,0,0,0,0,0,0,0,0,0.
[layer]
type=Tile Layer 2
data=
0,0,0,0,0,0,0,0,0,52,0,
0,0,52,52,52,0,0,0,52,52,52,
0,46,0,0,0,46,0,0,46,46,46,
0,45,0,0,0,45,0,0,0,45,0,
39,39,39,39,39,39,39,0,0,39,0,
35,35,35,35,35,35,35,0,35,35,0,
38,38,38,38,38,38,38,0,0,38,0,
0,41,41,41,41,41,0,0,41,41,0,
0,0,0,0,0,0,0,0,0,0,0,
0,0,0,0,0,0,0,0,0,0,0,
0,0,0,0,0,0,0,0,0,0,0,
0,0,0,0,0,0,0,0,0,0,0,
0,0,0,0,0,0,0,0,0,0,0.