[layer]
type=Tile Layer 1
data=
1,0,1,1,1,1,1,1,1,1,1,
0,21,1,1,1,0,0,0,0,0,1,
0,0,0,1,1,0,0,0,0,0,0,
0,0,0,1,1,0,0,0,0,21,1,
0,0,1,1,0,0,0,21,0,1,1,
1,1,0,0,0,0,0,21,0,1,1,
1,1,1,1,0,0,0,0,0,21,0,
0,1,1,1,0,0,0,21,0,0,0,
0,1,1,1,1,1,1,0,21,0,0,
1,1,1,1,0,1,1,1,1,1,1,
0,1,0,1,1,1,1,21,0,0,1,
0,1,1,0,1,1,21,1,1,0,1,
1,1,1,0,1,0,1,1,21,1,1,
0,0,1,1,1,1,0,0,21,0,1,
0,0,1,1,0,1,0,0,21,0,1,
0,0,0,0,0,0,0,0,0,0,0,
0,0,0,0,0,0,0,0,0,0,0,
0,0,0,0,0,0,0,0,0,0,0,
0,0,0,0,0,0,0,0,0,0,0.
[layer]
type=Tile Layer 2
data=
54,0,54,54,54,54,54,54,54,54,54,
0,0,77,77,77,0,0,0,0,0,77,
0,0,0,70,70,0,0,0,0,0,0,
0,0,0,70,70,0,0,0,0,0,70,
0,0,69,69,0,0,0,0,0,69,69,
62,62,0,0,0,0,0,0,0,62,62,
61,61,61,61,0,0,0,0,0,0,0,
0,60,60,60,0,0,0,0,0,0,0,
0,53,53,53,53,53,53,0,0,0,0,
37,37,37,37,0,37,37,37,37,37,37,
0,52,0,52,52,52,52,0,0,0,52,
0,51,51,0,51,51,0,51,51,0,51,
45,45,45,0,45,0,45,45,0,45,45,
0,0,49,49,49,49,0,0,0,0,49,
0,0,48,48,0,48,0,0,0,0,48,
0,0,0,0,0,0,0,0,0,0,0,
0,0,0,0,0,0,0,0,0,0,0,
0,0,0,0,0,0,0,0,0,0,0,
0,0,0,0,0,0,0,0,0,0,0.