[layer]
type=Tile Layer 1
data=
0,1,1,1,1,1,1,1,1,7,0,
1,1,0,8,7,0,0,0,1,1,0,
1,8,1,1,1,1,16,16,21,1,0,
17,8,1,1,1,17,1,1,21,1,0,
1,21,1,0,1,1,0,1,21,1,0,
1,21,1,17,1,1,1,17,21,1,24,
1,0,0,1,1,1,1,0,0,1,0,
0,1,0,1,0,0,1,0,1,8,0,
0,0,21,1,0,0,1,21,0,0,0,
0,0,0,0,0,0,0,0,0,0,0,
0,0,0,0,0,0,0,0,0,0,0,
0,0,0,0,0,0,0,0,0,0,0,
0,0,0,0,0,0,0,0,0,0,0.
[layer]
type=Tile Layer 2
data=
0,124,124,124,124,124,124,124,124,0,0,
166,166,0,0,0,0,0,0,166,166,0,
112,0,112,112,112,112,56,56,0,112,0,
55,0,111,111,111,55,111,111,0,111,0,
73,0,73,0,73,73,0,73,0,73,0,
106,0,106,53,106,106,106,53,0,106,0,
69,0,0,69,69,69,69,0,0,69,0,
0,103,0,103,0,0,103,0,103,0,0,
0,0,0,69,0,0,69,0,0,0,0,
0,0,0,0,0,0,0,0,0,0,0,
0,0,0,0,0,0,0,0,0,0,0,
0,0,0,0,0,0,0,0,0,0,0,
0,0,0,0,0,0,0,0,0,0,0.