[layer]
type=Tile Layer 1
data=
1,0,0,6,5,21,21,1,1,0,0,
0,0,0,1,4,1,6,1,1,1,0,
0,0,0,21,1,3,1,1,1,4,0,
0,0,0,21,1,1,1,1,3,5,0,
0,0,0,0,21,3,1,6,1,1,0,
21,0,0,0,0,5,1,5,1,1,0,
1,21,0,0,0,1,5,1,6,0,0,
1,1,21,0,0,3,6,1,0,0,0,
1,4,1,21,0,6,1,0,0,0,0,
0,0,0,0,0,0,0,0,0,0,0,
0,0,0,0,0,0,0,0,0,0,0,
0,0,0,0,0,0,0,0,0,0,0,
0,0,0,0,0,0,0,0,0,0,0.
[layer]
type=Tile Layer 2
data=
74,0,0,74,74,0,0,74,74,0,0,
0,0,0,72,72,72,72,72,72,72,0,
0,0,0,0,65,65,65,65,65,65,0,
0,0,0,0,64,64,64,64,64,64,0,
0,0,0,0,0,63,63,63,63,63,0,
0,0,0,0,0,62,62,62,62,62,0,
61,0,0,0,0,61,61,61,61,0,0,
60,60,0,0,0,60,60,60,0,0,0,
59,59,59,0,0,59,59,0,0,0,0,
0,0,0,0,0,0,0,0,0,0,0,
0,0,0,0,0,0,0,0,0,0,0,
0,0,0,0,0,0,0,0,0,0,0,
0,0,0,0,0,0,0,0,0,0,0.