[layer]
type=Tile Layer 1
data=
1,0,1,1,1,1,1,1,1,1,1,
0,1,1,1,1,1,1,0,21,7,0,
7,0,21,0,1,1,1,1,1,1,0,
1,1,1,0,0,1,1,1,1,1,21,
0,7,0,1,1,1,1,1,0,0,0,
0,0,1,1,1,1,21,1,1,1,1,
1,0,0,1,1,1,0,0,0,21,1,
1,1,0,1,1,1,1,1,1,21,0,
1,1,0,1,1,1,1,1,1,1,0,
1,1,0,0,0,1,1,1,0,21,0,
1,1,1,1,21,1,0,0,0,1,1,
0,0,0,0,0,0,0,0,0,0,0,
0,0,0,0,0,0,0,0,0,0,0,
0,0,0,0,0,0,0,0,0,0,0,
0,0,0,0,0,0,0,0,0,0,0.
[layer]
type=Tile Layer 2
data=
42,0,42,42,42,42,42,42,42,42,42,
0,84,84,84,84,84,84,0,0,0,0,
0,0,0,0,82,82,82,82,82,82,0,
48,48,48,0,0,48,48,48,48,48,0,
0,0,0,70,70,70,70,70,0,0,0,
0,0,43,43,43,43,0,43,43,43,43,
46,0,0,46,46,46,0,0,0,0,46,
41,41,0,41,41,41,41,41,41,0,0,
36,36,0,36,36,36,36,36,36,36,0,
45,45,0,0,0,45,45,45,0,0,0,
44,44,44,44,0,44,0,0,0,44,44,
0,0,0,0,0,0,0,0,0,0,0,
0,0,0,0,0,0,0,0,0,0,0,
0,0,0,0,0,0,0,0,0,0,0,
0,0,0,0,0,0,0,0,0,0,0.