[layer]
type=Tile Layer 1
data=
21,1,0,1,0,1,0,1,0,1,0,
0,1,21,1,0,17,0,1,0,1,0,
0,1,0,1,21,1,24,1,0,1,0,
0,0,1,0,1,21,1,0,1,0,1,
0,0,1,0,1,0,1,21,1,0,1,
0,0,1,0,17,24,1,0,1,21,1,
0,1,0,1,0,1,0,1,21,1,0,
0,1,0,1,0,1,21,1,0,1,0,
0,16,0,1,21,1,0,1,0,1,0,
0,0,0,0,0,0,0,0,0,0,0,
0,0,0,0,0,0,0,0,0,0,0,
0,0,0,0,0,0,0,0,0,0,0,
0,0,0,0,0,0,0,0,0,0,0.
[layer]
type=Tile Layer 2
data=
0,85,0,85,0,85,0,85,0,85,0,
0,84,0,84,0,42,0,84,0,84,0,
0,112,0,112,0,112,0,112,0,112,0,
0,0,74,0,74,0,74,0,74,0,74,
0,0,73,0,73,0,73,0,73,0,73,
0,0,108,0,54,0,108,0,108,0,108,
0,71,0,71,0,71,0,71,0,71,0,
0,70,0,70,0,70,0,70,0,70,0,
0,34,0,69,0,69,0,69,0,69,0,
0,0,0,0,0,0,0,0,0,0,0,
0,0,0,0,0,0,0,0,0,0,0,
0,0,0,0,0,0,0,0,0,0,0,
0,0,0,0,0,0,0,0,0,0,0.