[layer]
type=Tile Layer 1
data=
1,1,1,1,1,1,1,0,1,1,1,
1,1,1,0,0,1,1,1,21,0,1,
1,1,1,0,21,1,1,1,0,0,0,
1,1,21,0,1,1,1,1,1,1,0,
1,1,0,0,0,1,1,1,0,0,0,
1,1,1,1,0,1,1,1,0,0,21,
1,0,21,0,0,1,1,1,1,1,0,
1,0,1,1,1,1,1,1,1,1,1,
1,21,0,1,1,1,0,0,1,1,1,
1,1,0,0,1,21,0,0,1,1,1,
1,1,1,0,1,0,21,1,1,1,1,
1,1,1,0,0,1,21,1,1,1,1,
1,1,1,21,0,0,0,1,1,1,1,
0,0,0,0,0,0,0,0,0,0,0,
0,0,0,0,0,0,0,0,0,0,0,
0,0,0,0,0,0,0,0,0,0,0,
0,0,0,0,0,0,0,0,0,0,0.
[layer]
type=Tile Layer 2
data=
48,48,48,48,48,48,48,0,48,48,48,
68,68,68,0,0,68,68,68,0,0,68,
66,66,66,0,0,66,66,66,0,0,0,
54,54,0,0,54,54,54,54,54,54,0,
59,59,0,0,0,59,59,59,0,0,0,
59,59,59,59,0,59,59,59,0,0,0,
52,0,0,0,0,52,52,52,52,52,0,
36,0,36,36,36,36,36,36,36,36,36,
51,0,0,51,51,51,0,0,51,51,51,
50,50,0,0,50,0,0,0,50,50,50,
44,44,44,0,44,0,0,44,44,44,44,
43,43,43,0,0,43,0,43,43,43,43,
47,47,47,0,0,0,0,47,47,47,47,
0,0,0,0,0,0,0,0,0,0,0,
0,0,0,0,0,0,0,0,0,0,0,
0,0,0,0,0,0,0,0,0,0,0,
0,0,0,0,0,0,0,0,0,0,0.