[layer]
type=Tile Layer 1
data=
1,1,1,1,1,1,1,0,1,1,1,
1,1,1,1,21,1,1,1,1,8,0,
1,1,1,0,21,1,1,1,1,0,0,
2,1,1,0,0,1,1,2,1,21,0,
1,2,1,0,0,1,1,2,7,21,0,
1,1,1,21,0,1,1,1,0,1,1,
1,2,0,21,0,2,1,1,0,0,1,
1,1,0,1,1,1,1,1,1,0,21,
2,2,21,1,1,1,1,1,1,1,7,
1,1,0,21,2,1,1,2,1,1,0,
1,1,1,0,21,2,2,1,0,0,0,
1,1,1,1,0,1,1,1,0,21,0,
0,0,0,0,21,1,1,1,1,0,1,
1,0,1,1,1,1,1,1,1,1,1,
0,0,0,1,1,0,0,1,1,1,1,
1,1,0,1,1,21,0,0,0,1,1,
1,21,0,1,1,1,1,0,0,1,1,
0,0,0,0,0,0,0,0,0,0,0,
0,0,0,0,0,0,0,0,0,0,0,
0,0,0,0,0,0,0,0,0,0,0,
0,0,0,0,0,0,0,0,0,0,0.
[layer]
type=Tile Layer 2
data=
60,60,60,60,60,60,60,0,60,60,60,
124,124,124,124,0,124,124,124,124,0,0,
91,91,91,0,0,91,91,91,91,0,0,
90,90,90,0,0,90,90,90,90,0,0,
123,123,123,0,0,123,123,123,0,0,0,
73,73,73,0,0,73,73,73,0,73,73,
79,79,0,0,0,79,79,79,0,0,79,
65,65,0,65,65,65,65,65,65,0,0,
85,85,0,85,85,85,85,85,85,85,0,
63,63,0,0,63,63,63,63,63,63,0,
62,62,62,0,0,62,62,62,0,0,0,
61,61,61,61,0,61,61,61,0,0,0,
0,0,0,0,0,60,60,60,60,0,60,
42,0,42,42,42,42,42,42,42,42,42,
0,0,0,59,59,0,0,59,59,59,59,
59,59,0,59,59,0,0,0,0,59,59,
58,0,0,58,58,58,58,0,0,58,58,
0,0,0,0,0,0,0,0,0,0,0,
0,0,0,0,0,0,0,0,0,0,0,
0,0,0,0,0,0,0,0,0,0,0,
0,0,0,0,0,0,0,0,0,0,0.