[layer]
type=Tile Layer 1
data=
0,1,16,1,1,21,1,1,16,1,0,
0,1,1,1,21,0,0,1,1,1,0,
0,2,2,21,0,1,0,0,2,2,0,
0,2,21,0,1,1,1,0,0,2,0,
0,0,0,0,5,1,6,0,0,21,0,
0,2,0,0,0,0,0,0,21,2,0,
0,1,1,0,0,0,0,21,1,1,0,
0,0,0,0,0,0,0,0,0,0,0,
0,0,0,0,0,0,0,0,0,0,0,
0,0,0,0,0,0,0,0,0,0,0,
0,0,0,0,0,0,0,0,0,0,0.
[layer]
type=Tile Layer 2
data=
0,36,18,36,36,0,36,36,18,36,0,
0,39,39,39,0,0,0,39,39,39,0,
0,39,39,0,0,39,0,0,39,39,0,
0,38,0,0,38,38,38,0,0,38,0,
0,0,0,0,37,37,37,0,0,0,0,
0,36,0,0,0,0,0,0,0,36,0,
0,36,36,0,0,0,0,0,36,36,0,
0,0,0,0,0,0,0,0,0,0,0,
0,0,0,0,0,0,0,0,0,0,0,
0,0,0,0,0,0,0,0,0,0,0,
0,0,0,0,0,0,0,0,0,0,0.