[layer]
type=Tile Layer 1
data=
16,16,16,1,1,16,16,1,16,0,1,
1,2,19,2,17,2,0,17,17,19,1,
16,3,0,1,16,3,16,16,16,16,1,
0,0,19,19,0,0,0,0,0,21,19,
2,0,2,2,1,1,2,8,2,1,1,
17,1,17,0,17,17,17,17,1,1,1,
1,2,16,16,18,18,2,0,1,18,1,
0,0,8,19,19,0,0,0,0,0,19,
2,21,18,3,1,18,16,18,1,18,1,
19,0,0,0,0,0,24,21,19,0,0,
2,2,2,2,2,1,1,21,2,7,1,
19,0,21,0,0,19,19,0,8,0,19,
2,21,2,7,1,2,6,4,2,1,1,
2,0,2,21,24,0,0,0,0,2,2,
0,21,16,0,7,0,0,0,16,0,0,
17,5,19,8,19,2,2,17,19,21,1,
16,16,16,0,21,0,0,0,0,24,0,
17,19,0,2,17,19,19,17,2,2,1,
18,16,16,18,18,2,18,0,2,21,1,
0,21,0,19,19,0,0,0,19,0,0,
2,16,2,18,2,21,18,16,16,18,1,
0,0,21,0,0,0,19,0,0,0,19,
2,6,16,18,18,18,18,21,18,0,1,
21,0,0,0,0,0,0,0,17,0,17,
18,2,16,18,16,0,18,18,2,21,1,
2,21,0,0,0,0,2,0,0,0,2,
16,21,2,1,16,18,2,0,18,18,1,
0,0,2,0,21,17,19,0,19,0,0,
1,18,18,21,2,18,16,0,18,0,1,
2,21,0,0,2,0,0,0,2,0,2,
2,21,16,2,18,0,18,16,18,0,1,
0,0,0,0,19,0,0,0,0,0,19,
2,1,2,21,1,6,2,0,2,2,1,
0,0,19,0,0,0,21,0,19,0,0,
2,21,16,2,16,18,18,18,1,0,1,
17,0,0,17,17,21,0,0,0,0,17,
18,21,2,16,18,0,6,1,18,18,1,
0,0,17,0,0,0,19,2,19,0,21,
16,16,16,21,16,16,1,0,5,0,1,
1,0,21,0,1,3,0,8,0,0,0,
2,21,2,1,2,2,1,6,4,2,1,
2,0,0,0,21,0,0,0,0,0,2,
1,4,3,1,1,1,6,1,1,21,1,
0,0,0,0,0,0,21,6,1,0,1,
1,2,6,21,2,1,2,2,2,0,1,
5,0,21,0,1,0,0,0,0,0,1,
3,8,1,4,1,21,1,1,5,1,1,
0,0,5,21,0,0,1,1,0,0,1,
1,21,1,0,3,1,1,6,1,0,1,
17,0,17,0,17,17,21,0,0,0,0,
4,1,2,0,2,2,2,2,4,2,1,
0,0,4,0,21,0,1,0,0,0,0,
1,4,1,5,5,0,1,21,1,1,1,
4,8,0,1,1,0,1,0,0,0,21,
1,0,1,6,1,21,4,1,1,4,1,
1,0,21,0,1,0,0,0,5,4,1,
2,2,2,21,2,1,2,0,5,0,1,
21,0,0,0,0,1,5,0,1,0,0,
16,16,16,16,16,16,1,21,1,0,1,
0,0,0,0,1,0,0,0,5,21,0,
3,1,4,0,1,21,1,1,5,1,1,
17,17,17,0,1,0,17,0,0,0,21,
16,21,16,0,16,0,1,0,1,16,1,
17,0,17,0,0,0,17,0,0,21,17,
16,0,2,16,4,2,18,18,18,21,1,
3,3,1,1,3,1,0,1,1,1,1,
2,1,2,1,2,0,2,2,5,1,1,
3,0,1,1,3,1,1,21,1,4,1,
1,0,0,0,0,0,3,0,21,0,0,
1,3,1,1,1,21,3,4,1,1,1,
1,1,0,0,0,0,4,0,21,0,0,
0,0,0,0,0,0,0,0,0,0,0,
0,0,0,0,0,0,0,0,0,0,0,
0,0,0,0,0,0,0,0,0,0,0,
0,0,0,0,0,0,0,0,0,0,0.
[layer]
type=Tile Layer 2
data=
92,92,92,184,184,92,92,184,92,0,184,
200,200,200,200,100,200,0,100,100,200,200,
100,200,0,200,100,200,100,100,100,100,200,
0,0,200,200,0,0,0,0,0,0,200,
274,0,274,274,274,274,274,0,274,274,274,
91,183,91,0,91,91,91,91,183,183,183,
183,183,91,91,183,183,183,0,183,183,183,
0,0,0,298,298,0,0,0,0,0,298,
199,0,199,199,199,199,99,199,199,199,199,
297,0,0,0,0,0,0,0,297,0,0,
271,271,271,271,271,271,271,0,271,0,271,
270,0,0,0,0,270,270,0,0,0,270,
268,0,268,0,268,268,268,268,268,268,268,
289,0,289,0,0,0,0,0,0,289,289,
0,0,144,0,0,0,0,0,144,0,0,
143,286,286,0,286,286,286,143,286,0,286,
131,131,131,0,0,0,0,0,0,0,0,
86,173,0,173,86,173,173,86,173,173,173,
173,86,86,173,173,173,173,0,173,0,173,
0,0,0,187,187,0,0,0,187,0,0,
186,93,186,186,186,0,186,93,93,186,186,
0,0,0,0,0,0,185,0,0,0,185,
169,169,84,169,169,169,169,0,169,0,169,
0,0,0,0,0,0,0,0,84,0,84,
167,167,83,167,83,0,167,167,167,0,167,
180,0,0,0,0,0,180,0,0,0,180,
89,0,179,179,89,179,179,0,179,179,179,
0,0,178,0,0,89,178,0,178,0,0,
162,162,162,0,162,162,81,0,162,0,162,
161,0,0,0,161,0,0,0,161,0,161,
160,0,80,160,160,0,160,80,160,0,160,
0,0,0,0,173,0,0,0,0,0,173,
173,173,173,0,173,173,173,0,173,173,173,
0,0,172,0,0,0,0,0,172,0,0,
157,0,78,157,78,157,157,157,157,0,157,
78,0,0,78,78,0,0,0,0,0,78,
155,0,155,77,155,0,155,155,155,155,155,
0,0,83,0,0,0,167,167,167,0,0,
83,83,83,0,83,83,166,0,166,0,166,
246,0,0,0,246,246,0,0,0,0,0,
150,0,150,150,150,150,150,150,150,150,150,
149,0,0,0,0,0,0,0,0,0,149,
148,148,148,148,148,148,148,148,148,0,148,
0,0,0,0,0,0,0,160,160,0,160,
158,158,158,0,158,158,158,158,158,0,158,
157,0,0,0,157,0,0,0,0,0,157,
216,0,216,216,216,0,216,216,216,216,216,
0,0,143,0,0,0,143,143,0,0,143,
142,0,142,0,142,142,142,142,142,0,142,
76,0,76,0,76,76,0,0,0,0,0,
151,151,151,0,151,151,151,151,151,151,151,
0,0,151,0,0,0,151,0,0,0,0,
138,138,138,138,138,0,138,0,138,138,138,
205,0,0,205,205,0,205,0,0,0,0,
136,0,136,136,136,0,136,136,136,136,136,
146,0,0,0,146,0,0,0,146,146,146,
145,145,145,0,145,145,145,0,145,0,145,
0,0,0,0,0,144,144,0,144,0,0,
66,66,66,66,66,66,132,0,132,0,132,
0,0,0,0,131,0,0,0,131,0,0,
129,129,129,0,129,0,129,129,129,129,129,
59,59,59,0,118,0,59,0,0,0,0,
58,0,58,0,58,0,117,0,117,58,117,
58,0,58,0,0,0,58,0,0,0,58,
52,0,104,52,104,104,104,104,104,0,104,
103,103,103,103,103,103,0,103,103,103,103,
103,103,103,103,103,0,103,103,103,103,103,
103,0,103,103,103,103,103,0,103,103,103,
102,0,0,0,0,0,102,0,0,0,0,
101,101,101,101,101,0,101,101,101,101,101,
100,100,0,0,0,0,100,0,0,0,0,
0,0,0,0,0,0,0,0,0,0,0,
0,0,0,0,0,0,0,0,0,0,0,
0,0,0,0,0,0,0,0,0,0,0,
0,0,0,0,0,0,0,0,0,0,0.