[layer]
type=Tile Layer 1
data=
21,21,1,1,1,1,1,1,1,21,21,
21,0,0,1,1,1,1,1,0,0,21,
0,0,1,1,1,1,1,1,1,0,0,
0,1,1,1,1,21,1,1,1,1,0,
0,1,1,1,1,21,1,1,1,1,0,
0,1,1,1,1,21,1,1,1,1,0,
0,1,1,1,1,21,1,1,1,1,0,
0,0,1,1,1,1,1,1,1,0,0,
1,0,0,1,1,1,1,1,0,0,1,
0,0,0,0,0,0,0,0,0,0,0,
0,0,0,0,0,0,0,0,0,0,0,
0,0,0,0,0,0,0,0,0,0,0,
0,0,0,0,0,0,0,0,0,0,0.
[layer]
type=Tile Layer 2
data=
0,0,63,63,63,63,63,63,63,0,0,
0,0,0,59,59,59,59,59,0,0,0,
0,0,51,51,51,51,51,51,51,0,0,
0,51,51,51,51,0,51,51,51,51,0,
0,50,50,50,50,0,50,50,50,50,0,
0,49,49,49,49,0,49,49,49,49,0,
0,48,48,48,48,0,48,48,48,48,0,
0,0,48,48,48,48,48,48,48,0,0,
48,0,0,48,48,48,48,48,0,0,48,
0,0,0,0,0,0,0,0,0,0,0,
0,0,0,0,0,0,0,0,0,0,0,
0,0,0,0,0,0,0,0,0,0,0,
0,0,0,0,0,0,0,0,0,0,0.