[layer]
type=Tile Layer 1
data=
0,6,0,1,7,16,16,1,1,16,21,
2,1,1,2,1,2,1,2,2,1,0,
0,16,4,5,18,2,2,18,16,18,1,
5,2,17,1,2,17,2,19,17,0,1,
3,16,0,0,0,0,0,16,16,16,1,
8,0,0,17,17,2,0,0,0,2,0,
4,2,2,0,2,1,1,2,6,2,1,
19,19,19,19,0,0,0,0,8,19,1,
5,1,1,6,0,7,0,21,0,1,1,
2,1,17,17,21,19,19,2,19,1,1,
1,18,16,18,21,18,1,2,8,18,1,
2,5,2,2,1,2,2,1,21,1,1,
0,1,21,0,0,16,3,16,0,0,0,
2,2,8,0,0,17,17,19,21,0,0,
0,0,21,18,16,16,0,2,4,2,1,
1,19,19,6,7,17,1,17,2,2,21,
5,6,2,1,2,0,2,0,2,2,1,
17,0,17,17,1,21,6,8,1,17,1,
18,21,2,18,1,16,3,4,18,3,1,
17,21,19,2,19,0,0,7,2,17,1,
18,0,16,2,18,7,21,0,1,18,1,
19,0,1,0,1,19,17,2,19,21,1,
0,0,1,0,16,18,16,2,2,0,1,
0,0,1,0,6,1,17,17,17,0,1,
18,4,18,0,4,2,16,2,16,21,1,
2,0,0,0,21,0,2,0,2,0,1,
16,2,16,21,2,2,18,0,4,16,1,
1,0,1,0,1,17,19,2,19,0,21,
18,21,5,0,1,16,2,16,2,0,0,
19,4,1,2,17,2,19,0,19,17,1,
0,0,0,0,2,2,1,1,6,21,0,
2,2,17,21,2,17,6,2,17,17,1,
2,0,5,18,18,0,18,16,1,21,1,
0,21,19,0,19,0,19,0,0,0,1,
18,0,18,21,1,0,16,2,18,0,1,
17,0,17,21,1,0,17,17,6,0,1,
1,3,2,0,6,2,1,2,2,21,1,
17,1,2,0,17,2,3,19,19,21,1,
0,0,0,0,16,21,1,0,16,0,1,
1,17,1,17,1,0,17,3,1,17,1,
1,1,1,21,5,3,1,0,3,1,1,
6,0,0,0,1,1,4,0,1,21,0,
3,3,1,0,1,1,6,21,1,1,1,
1,1,4,21,1,1,3,0,1,4,1,
1,0,0,0,1,1,6,0,21,0,0,
2,0,0,0,2,1,3,21,1,2,1,
0,0,21,7,16,5,16,0,1,1,1,
2,1,4,1,1,2,2,1,2,8,21,
5,6,1,2,2,1,2,2,1,7,21,
0,0,6,1,1,1,5,21,0,0,0,
16,0,1,16,16,16,1,21,0,0,0,
2,0,1,2,1,2,2,21,0,7,0,
1,0,16,16,16,1,5,21,16,1,1,
17,0,0,0,0,21,3,0,17,17,1,
6,1,3,0,1,1,4,21,1,1,1,
1,1,5,0,1,0,0,0,0,0,21,
1,1,5,0,1,3,1,21,0,0,1,
6,1,1,21,0,0,6,0,0,7,1,
6,2,0,5,2,1,2,2,2,1,1,
8,0,21,0,5,1,1,0,0,0,1,
0,0,0,0,1,1,6,21,0,0,1,
1,1,1,0,5,1,1,21,3,6,1,
6,1,1,21,1,0,0,0,6,1,1,
17,17,5,21,1,17,1,5,4,17,1,
18,0,0,0,2,1,16,0,0,21,0,
1,6,1,0,1,6,1,21,0,0,1,
6,0,5,0,1,1,1,0,21,0,1,
4,21,1,0,5,1,1,0,0,0,1,
2,0,2,2,5,21,0,0,2,6,1,
21,0,1,6,4,0,0,0,1,1,1,
1,1,1,1,1,4,5,21,3,1,1,
0,0,0,0,0,0,0,0,0,0,0,
0,0,0,0,0,0,0,0,0,0,0,
0,0,0,0,0,0,0,0,0,0,0,
0,0,0,0,0,0,0,0,0,0,0.
[layer]
type=Tile Layer 2
data=
0,265,0,265,0,132,132,265,265,132,0,
134,134,134,134,134,134,134,134,134,134,0,
0,67,134,134,134,134,134,134,67,134,134,
134,134,67,134,134,67,134,134,67,0,134,
176,88,0,0,0,0,0,88,88,88,176,
0,0,0,132,132,264,0,0,0,264,0,
123,123,123,0,123,123,123,123,123,123,123,
288,288,288,288,0,0,0,0,0,288,288,
288,288,288,288,0,0,0,0,0,288,288,
134,134,67,67,0,134,134,134,134,134,134,
210,210,105,210,0,210,210,210,0,210,210,
121,121,121,121,121,121,121,121,0,121,121,
0,172,0,0,0,86,172,86,0,0,0,
279,279,0,0,0,139,139,279,0,0,0,
0,0,0,185,92,92,0,185,185,185,185,
222,222,222,222,0,111,222,111,222,222,0,
134,134,134,134,134,0,134,0,134,134,134,
113,0,113,113,226,0,226,0,226,113,226,
117,0,117,117,117,58,117,117,117,117,117,
135,0,270,270,270,0,0,0,270,135,270,
268,0,134,268,268,0,0,0,268,268,268,
160,0,160,0,160,160,80,160,160,0,160,
0,0,162,0,81,162,81,162,162,0,162,
0,0,162,0,162,162,81,81,81,0,162,
130,130,130,0,130,130,65,130,65,0,130,
175,0,0,0,0,0,175,0,175,0,175,
69,139,69,0,139,139,139,0,139,69,139,
173,0,173,0,173,86,173,173,173,0,0,
158,0,158,0,158,79,158,79,158,0,0,
110,110,110,110,55,110,110,0,110,55,110,
0,0,0,0,156,156,156,156,156,0,0,
119,119,59,0,119,59,119,119,59,59,119,
151,0,151,151,151,0,151,75,151,0,151,
0,0,167,0,167,0,167,0,0,0,167,
152,0,152,0,152,0,76,152,152,0,152,
75,0,75,0,151,0,75,75,151,0,151,
120,120,120,0,120,120,120,120,120,0,120,
65,130,130,0,65,130,130,130,130,0,130,
0,0,0,0,80,0,161,0,80,0,161,
113,56,113,56,113,0,56,113,113,56,113,
118,118,118,0,118,118,118,0,118,118,118,
145,0,0,0,145,145,145,0,145,0,0,
116,116,116,0,116,116,116,0,116,116,116,
125,125,125,0,125,125,125,0,125,125,125,
155,0,0,0,155,155,155,0,0,0,0,
154,0,0,0,154,154,154,0,154,154,154,
0,0,0,0,105,210,105,0,210,210,210,
166,166,166,166,166,166,166,166,166,0,0,
165,165,165,165,165,165,165,165,165,0,0,
0,0,149,149,149,149,149,0,0,0,0,
74,0,148,74,74,74,148,0,0,0,0,
219,0,219,219,219,219,219,0,0,0,0,
107,0,53,53,53,107,107,0,53,107,107,
66,0,0,0,0,0,132,0,66,66,132,
105,105,105,0,105,105,105,0,105,105,105,
142,142,142,0,142,0,0,0,0,0,0,
140,140,140,0,140,140,140,0,0,0,140,
208,208,208,0,0,0,208,0,0,0,208,
89,89,0,89,89,89,89,89,89,89,89,
0,0,0,0,190,190,190,0,0,0,190,
0,0,0,0,126,126,126,0,0,0,126,
92,92,92,0,92,92,92,0,92,92,92,
113,113,113,0,113,0,0,0,113,113,113,
39,39,79,0,79,39,79,79,79,39,79,
100,0,0,0,100,100,50,0,0,0,0,
99,99,99,0,99,99,99,0,0,0,99,
98,0,98,0,98,98,98,0,0,0,98,
97,0,97,0,97,97,97,0,0,0,97,
96,0,96,96,96,0,0,0,96,96,96,
0,0,95,95,95,0,0,0,95,95,95,
67,67,67,67,67,67,67,0,67,67,67,
0,0,0,0,0,0,0,0,0,0,0,
0,0,0,0,0,0,0,0,0,0,0,
0,0,0,0,0,0,0,0,0,0,0,
0,0,0,0,0,0,0,0,0,0,0.