[layer]
type=Tile Layer 1
data=
0,1,1,0,0,0,0,0,1,1,0,
0,4,1,0,0,0,0,0,1,3,0,
0,0,0,1,0,0,0,1,0,0,0,
1,1,1,1,1,0,1,1,1,1,1,
1,0,1,1,1,1,1,1,1,0,1,
1,1,1,1,1,0,1,1,1,1,1,
1,1,1,1,1,0,1,1,1,1,1,
1,1,1,1,0,1,0,1,1,1,1,
1,22,1,1,1,0,1,1,1,22,1,
1,1,1,1,1,1,1,0,1,1,1,
0,1,1,1,1,1,1,1,1,1,0,
0,0,1,1,1,1,1,1,1,0,0,
0,21,0,1,1,1,1,1,0,21,0,
0,0,0,0,1,23,1,0,0,0,0,
21,0,0,0,0,1,0,0,0,0,21,
0,0,1,0,0,0,0,0,1,0,0,
0,0,0,1,1,21,1,1,0,0,0,
0,0,0,0,0,0,0,0,0,0,0,
0,0,0,0,0,0,0,0,0,0,0,
0,0,0,0,0,0,0,0,0,0,0,
0,0,0,0,0,0,0,0,0,0,0.
[layer]
type=Tile Layer 2
data=
0,104,104,0,0,0,0,0,104,104,0,
0,113,113,0,0,0,0,0,113,113,0,
0,0,0,113,0,0,0,113,0,0,0,
102,102,102,102,102,0,102,102,102,102,102,
104,0,104,104,104,104,104,104,104,0,104,
94,94,94,94,94,0,94,94,94,94,94,
94,94,94,94,94,0,94,94,94,94,94,
96,96,96,96,0,96,0,96,96,96,96,
96,0,96,96,96,0,96,96,96,0,96,
85,85,85,85,85,85,85,0,85,85,85,
0,85,85,85,85,85,85,85,85,85,0,
0,0,85,85,85,85,85,85,85,0,0,
0,0,0,85,85,85,85,85,0,0,0,
0,0,0,0,83,0,83,0,0,0,0,
0,0,0,0,0,82,0,0,0,0,0,
0,0,80,0,0,0,0,0,80,0,0,
0,0,0,80,80,0,80,80,0,0,0,
0,0,0,0,0,0,0,0,0,0,0,
0,0,0,0,0,0,0,0,0,0,0,
0,0,0,0,0,0,0,0,0,0,0,
0,0,0,0,0,0,0,0,0,0,0.