[layer]
type=Tile Layer 1
data=
0,0,0,18,21,8,0,18,0,0,0,
0,1,17,1,17,17,0,17,24,5,1,
18,1,2,16,0,1,2,16,18,18,1,
2,19,1,19,1,3,19,17,0,17,1,
1,5,16,16,16,16,16,0,1,1,1,
21,1,1,3,0,0,0,7,0,0,0,
0,18,2,2,8,16,16,1,18,4,1,
21,0,0,19,24,19,0,0,0,0,0,
18,2,0,16,21,16,24,1,18,2,1,
0,21,0,19,0,0,0,19,0,24,0,
8,18,2,16,0,16,2,18,0,3,21,
21,19,1,0,0,19,0,0,0,19,0,
1,2,2,2,1,2,0,2,5,6,1,
0,2,0,8,0,0,21,2,0,0,0,
0,18,21,1,18,18,0,2,0,16,1,
0,17,0,21,0,1,0,0,0,17,0,
16,3,0,16,21,16,1,1,16,1,0,
0,19,21,19,0,0,8,0,0,19,0,
0,1,21,16,2,18,1,18,8,18,1,
0,19,0,6,0,0,19,19,8,0,0,
21,16,5,1,24,16,16,16,3,5,1,
1,2,2,6,7,2,1,2,0,4,0,
0,0,0,1,2,18,21,0,0,16,0,
19,0,19,17,6,19,17,2,2,1,1,
24,18,21,0,0,0,0,2,1,16,0,
0,19,19,1,19,2,3,1,21,17,1,
0,16,0,0,0,0,0,0,0,16,21,
1,1,0,17,2,17,17,2,2,19,21,
0,18,21,18,16,16,2,1,2,1,1,
0,0,0,2,0,0,0,0,3,2,21,
1,16,16,1,21,16,8,5,1,16,0,
24,1,6,2,2,2,4,2,1,1,21,
1,1,1,6,1,4,1,1,0,4,1,
5,6,21,1,5,1,1,1,0,1,1,
0,21,0,1,0,0,0,0,0,6,0,
1,3,5,1,21,1,4,1,1,1,0,
0,6,1,1,0,0,0,0,0,21,0,
21,1,17,17,1,1,5,1,17,17,1,
0,1,1,5,1,1,1,6,1,4,1,
1,1,6,1,1,1,1,6,5,1,21,
18,0,18,16,16,1,2,1,18,1,1,
0,5,1,1,2,2,2,1,21,2,0,
21,0,0,18,0,0,0,0,0,18,0,
6,1,0,1,21,1,4,3,1,1,1,
0,6,0,0,21,1,0,0,0,0,0,
0,1,4,1,5,1,1,3,1,1,1,
0,0,0,16,0,0,0,16,21,0,0,
0,1,0,1,24,1,6,6,21,1,1,
0,4,0,21,0,1,0,0,0,1,0,
5,2,1,19,19,19,21,17,19,1,1,
21,0,0,2,0,0,0,2,0,0,0,
1,1,21,1,0,4,1,1,8,4,0,
16,16,21,16,0,16,0,1,1,3,0,
0,0,0,1,21,2,0,0,0,2,0,
2,2,1,2,5,1,1,2,21,2,1,
1,1,1,0,1,1,5,1,5,1,1,
1,1,1,1,5,3,1,3,21,1,0,
0,1,0,21,0,0,0,4,0,7,0,
0,1,21,1,1,2,0,2,2,2,1,
0,0,0,4,1,1,0,0,21,0,0,
1,1,6,1,3,1,0,1,1,1,1,
0,0,0,0,0,0,0,0,0,0,0,
0,0,0,0,0,0,0,0,0,0,0,
0,0,0,0,0,0,0,0,0,0,0,
0,0,0,0,0,0,0,0,0,0,0.
[layer]
type=Tile Layer 2
data=
0,0,0,237,0,0,0,237,0,0,0,
0,235,117,235,117,117,0,117,0,235,235,
157,157,157,78,0,157,157,78,157,157,157,
171,171,171,171,171,171,171,85,0,85,171,
171,171,85,85,85,85,85,0,171,171,171,
0,256,256,256,0,0,0,0,0,0,0,
0,234,234,234,0,117,117,234,234,234,234,
0,0,0,234,0,234,0,0,0,0,0,
232,232,0,116,0,116,0,232,232,232,232,
0,0,0,250,0,0,0,250,0,0,0,
0,249,249,124,0,124,249,249,0,249,0,
0,165,165,0,0,165,0,0,0,165,0,
150,150,150,150,150,150,0,150,150,150,150,
0,225,0,0,0,0,0,225,0,0,0,
0,149,0,149,149,149,0,149,0,74,149,
0,80,0,0,0,161,0,0,0,80,0,
80,160,0,80,0,80,160,160,80,160,0,
0,238,0,238,0,0,0,0,0,238,0,
0,217,0,108,217,217,217,217,0,217,217,
0,216,0,216,0,0,216,216,0,0,0,
0,108,216,216,0,108,108,108,216,216,216,
232,232,232,232,0,232,232,232,0,232,0,
0,0,0,155,155,155,0,0,0,77,0,
154,0,154,77,154,154,77,154,154,154,154,
0,213,0,0,0,0,0,213,213,106,0,
0,141,141,141,141,141,141,141,0,70,141,
0,69,0,0,0,0,0,0,0,69,0,
150,150,0,75,150,75,75,150,150,150,0,
0,149,0,149,74,74,149,149,149,149,149,
0,0,0,148,0,0,0,0,148,148,0,
202,101,101,202,0,101,0,202,202,101,0,
0,201,201,201,201,201,201,201,201,201,0,
133,133,133,133,133,133,133,133,0,133,133,
144,144,0,144,144,144,144,144,0,144,144,
0,0,0,143,0,0,0,0,0,143,0,
142,142,142,142,0,142,142,142,142,142,0,
0,130,130,130,0,0,0,0,0,0,0,
0,128,64,64,128,128,128,128,64,64,128,
0,127,127,127,127,127,127,127,127,127,127,
138,138,138,138,138,138,138,138,138,138,0,
137,0,137,68,68,137,137,137,137,137,137,
0,137,137,137,137,137,137,137,0,137,0,
0,0,0,125,0,0,0,0,0,125,0,
124,124,0,124,0,124,124,124,124,124,124,
0,123,0,0,0,123,0,0,0,0,0,
0,132,132,132,132,132,132,132,132,132,132,
0,0,0,66,0,0,0,66,0,0,0,
0,196,0,196,0,196,196,196,0,196,196,
0,120,0,0,0,120,0,0,0,120,0,
119,119,119,119,119,119,0,59,119,119,119,
0,0,0,117,0,0,0,117,0,0,0,
160,160,0,160,0,160,160,160,0,160,0,
53,53,0,53,0,53,0,106,106,106,0,
0,0,0,105,0,105,0,0,0,105,0,
94,94,94,94,94,94,94,94,0,94,94,
93,93,93,0,93,93,93,93,93,93,93,
93,93,93,93,93,93,93,93,0,93,0,
0,138,0,0,0,0,0,138,0,0,0,
0,91,0,91,91,91,0,91,91,91,91,
0,0,0,90,90,90,0,0,0,0,0,
90,90,90,90,90,90,0,90,90,90,90,
0,0,0,0,0,0,0,0,0,0,0,
0,0,0,0,0,0,0,0,0,0,0,
0,0,0,0,0,0,0,0,0,0,0,
0,0,0,0,0,0,0,0,0,0,0.