[layer]
type=Tile Layer 1
data=
0,5,0,0,0,1,0,0,21,1,1,
1,24,5,6,1,1,2,2,21,0,1,
1,3,1,1,6,1,1,1,24,21,0,
0,1,0,0,1,4,1,0,21,0,0,
1,1,0,3,1,1,5,6,1,1,1,
0,1,21,0,1,0,1,5,0,0,0,
0,0,0,1,0,0,2,21,1,0,0,
0,4,0,1,0,0,1,0,21,0,0,
0,6,1,5,21,0,1,1,1,1,1,
0,0,4,0,21,0,2,1,2,1,1,
0,0,0,0,0,21,1,5,1,1,0,
0,0,0,0,1,0,6,1,1,0,21,
0,5,0,0,0,0,0,1,1,1,0,
0,0,0,0,0,0,0,0,0,0,0,
0,0,0,0,0,0,0,0,0,0,0,
0,0,0,0,0,0,0,0,0,0,0,
0,0,0,0,0,0,0,0,0,0,0.
[layer]
type=Tile Layer 2
data=
0,69,0,0,0,69,0,0,0,69,69,
91,0,91,91,91,91,91,91,0,0,91,
90,90,90,90,90,90,90,90,0,0,0,
0,60,0,0,60,60,60,0,0,0,0,
41,41,0,41,41,41,41,41,41,41,41,
0,59,0,0,59,0,59,59,0,0,0,
0,0,0,52,0,0,52,0,52,0,0,
0,51,0,51,0,0,51,0,0,0,0,
0,45,45,45,0,0,45,45,45,45,45,
0,0,49,0,0,0,49,49,49,49,49,
0,0,0,0,0,0,48,48,48,48,0,
0,0,0,0,47,0,47,47,47,0,0,
0,47,0,0,0,0,0,47,47,47,0,
0,0,0,0,0,0,0,0,0,0,0,
0,0,0,0,0,0,0,0,0,0,0,
0,0,0,0,0,0,0,0,0,0,0,
0,0,0,0,0,0,0,0,0,0,0.