[layer]
type=Tile Layer 1
data=
0,24,1,1,1,1,1,1,1,0,0,
0,1,1,1,1,1,1,1,1,1,0,
1,1,1,1,1,1,1,1,0,1,1,
1,1,1,1,2,2,2,1,0,1,1,
1,0,1,1,1,1,1,1,1,1,1,
1,1,2,1,2,1,1,2,2,0,1,
0,1,1,1,1,1,1,1,1,1,1,
7,1,1,1,1,1,1,1,1,1,7,
21,0,2,2,1,1,1,1,1,8,21,
0,0,1,2,1,1,1,1,2,0,0,
0,0,0,1,1,23,2,2,8,0,0,
0,0,21,1,2,1,2,1,21,7,0,
0,21,0,0,1,1,1,0,0,21,0,
0,0,0,1,7,2,0,2,0,0,0,
0,0,1,0,0,1,8,0,1,0,0,
0,21,0,0,0,1,8,0,0,21,0,
8,0,0,22,0,1,0,22,0,0,0,
0,0,0,0,0,0,0,0,0,0,0,
0,0,0,0,0,0,0,0,0,0,0,
0,0,0,0,0,0,0,0,0,0,0,
0,0,0,0,0,0,0,0,0,0,0.
[layer]
type=Tile Layer 2
data=
0,0,162,162,162,162,162,162,162,0,0,
0,117,117,117,117,117,117,117,117,117,0,
105,105,105,105,105,105,105,105,0,105,105,
105,105,105,105,105,105,105,105,0,105,105,
97,0,97,97,97,97,97,97,97,97,97,
97,97,97,97,97,97,97,97,97,0,97,
0,97,97,97,97,97,97,97,97,97,97,
0,198,198,198,198,198,198,198,198,198,0,
0,0,148,148,148,148,148,148,148,0,0,
0,0,97,97,97,97,97,97,97,0,0,
0,0,0,132,132,0,132,132,0,0,0,
0,0,0,130,130,130,130,130,0,0,0,
0,0,0,0,85,85,85,0,0,0,0,
0,0,0,124,0,124,0,124,0,0,0,
0,0,124,0,0,124,0,0,124,0,0,
0,0,0,0,0,124,0,0,0,0,0,
0,0,0,0,0,121,0,0,0,0,0,
0,0,0,0,0,0,0,0,0,0,0,
0,0,0,0,0,0,0,0,0,0,0,
0,0,0,0,0,0,0,0,0,0,0,
0,0,0,0,0,0,0,0,0,0,0.