[layer]
type=Tile Layer 1
data=
0,0,0,1,1,4,4,1,0,0,0,
0,0,1,5,0,1,0,1,6,0,0,
0,0,1,1,1,1,1,4,4,0,0,
0,0,1,4,0,1,0,4,1,0,0,
0,5,1,1,1,6,1,1,4,1,0,
0,6,21,21,0,0,0,21,21,5,0,
0,1,21,0,0,3,0,0,21,5,0,
0,5,5,21,1,5,1,21,1,1,0,
0,0,1,21,0,0,0,21,3,0,0,
0,0,0,0,0,0,0,0,0,0,0,
0,0,0,0,0,0,0,0,0,0,0,
0,0,0,0,0,0,0,0,0,0,0,
0,0,0,0,0,0,0,0,0,0,0.
[layer]
type=Tile Layer 2
data=
0,0,0,75,75,75,75,75,0,0,0,
0,0,75,75,0,75,0,75,75,0,0,
0,0,68,68,68,68,68,68,68,0,0,
0,0,68,68,0,68,0,68,68,0,0,
0,61,61,61,61,61,61,61,61,61,0,
0,68,0,0,0,0,0,0,0,68,0,
0,64,0,0,0,64,0,0,0,64,0,
0,62,62,0,62,62,62,0,62,62,0,
0,0,60,0,0,0,0,0,60,0,0,
0,0,0,0,0,0,0,0,0,0,0,
0,0,0,0,0,0,0,0,0,0,0,
0,0,0,0,0,0,0,0,0,0,0,
0,0,0,0,0,0,0,0,0,0,0.