[layer]
type=Tile Layer 1
data=
1,1,0,0,1,1,1,1,1,9,1,
1,1,0,1,1,1,9,1,1,1,1,
0,0,0,0,0,1,1,1,1,1,1,
1,1,1,1,0,0,0,0,0,0,0,
1,9,1,1,0,0,1,1,1,1,0,
1,1,0,1,0,0,0,0,0,1,0,
1,1,1,1,0,1,1,0,1,1,0,
0,1,0,1,1,1,1,1,1,1,0,
0,0,0,1,1,1,0,0,0,0,0,
0,0,0,0,0,0,0,0,0,0,0,
0,0,0,0,0,0,0,0,0,0,0.
[layer]
type=Tile Layer 2
data=
33,33,0,0,33,24,24,24,24,24,33,
29,29,0,29,21,21,21,21,21,21,29,
0,0,0,0,0,42,30,30,30,30,42,
42,30,30,42,0,0,0,0,0,0,0,
37,27,27,37,0,0,37,27,27,37,0,
42,42,0,60,0,0,0,0,0,60,0,
37,27,27,37,0,37,37,0,37,37,0,
0,70,0,70,50,50,50,50,50,70,0,
0,0,0,42,30,42,0,0,0,0,0,
0,0,0,0,0,0,0,0,0,0,0,
0,0,0,0,0,0,0,0,0,0,0.