[layer]
type=Tile Layer 1
data=
0,1,4,5,3,0,1,1,1,1,1,
1,1,6,3,1,0,1,3,1,1,0,
0,1,1,1,3,3,5,1,1,1,1,
0,0,21,21,6,0,5,21,21,0,0,
21,21,21,21,5,3,3,21,21,21,21,
1,1,1,1,5,0,3,1,4,1,0,
0,6,1,6,1,0,1,4,1,1,1,
0,0,0,0,0,0,0,0,0,0,0,
0,0,0,0,0,0,0,0,0,0,0,
0,0,0,0,0,0,0,0,0,0,0,
0,0,0,0,0,0,0,0,0,0,0.
[layer]
type=Tile Layer 2
data=
0,79,79,79,79,0,79,79,79,79,79,
79,79,79,79,79,0,79,79,79,79,0,
0,71,71,71,71,71,71,71,71,71,71,
0,0,0,0,79,0,79,0,0,0,0,
0,0,0,0,76,76,76,0,0,0,0,
69,69,69,69,69,0,69,69,69,69,0,
0,69,69,69,69,0,69,69,69,69,69,
0,0,0,0,0,0,0,0,0,0,0,
0,0,0,0,0,0,0,0,0,0,0,
0,0,0,0,0,0,0,0,0,0,0,
0,0,0,0,0,0,0,0,0,0,0.