[layer]
type=Tile Layer 1
data=
16,16,16,16,1,16,1,0,1,1,1,
0,0,0,2,19,7,0,0,0,17,0,
1,1,0,1,1,1,24,1,0,1,1,
1,1,17,17,1,1,1,17,0,17,1,
21,18,2,18,16,1,1,1,2,16,1,
1,2,2,1,1,2,2,1,1,0,1,
7,1,1,16,16,16,1,16,1,1,0,
1,1,21,17,1,17,1,1,17,17,1,
8,21,0,16,16,0,0,1,0,0,0,
17,19,21,2,19,2,0,1,0,17,1,
0,2,21,0,24,2,0,0,0,1,0,
8,17,1,1,21,17,1,17,17,1,0,
16,16,16,1,1,16,1,0,1,1,1,
24,19,0,0,0,21,0,19,0,0,0,
0,2,0,1,2,1,8,1,21,2,0,
2,0,17,1,2,2,1,19,17,17,1,
1,1,1,2,1,2,16,18,18,16,21,
21,19,2,1,1,17,1,19,17,2,1,
0,1,1,2,1,1,2,1,2,2,21,
0,17,21,0,0,2,17,24,0,2,0,
16,16,21,2,8,2,18,18,0,1,1,
19,1,19,2,17,1,17,0,19,2,1,
0,0,21,18,0,7,0,18,0,0,0,
1,2,21,2,0,2,1,2,0,1,1,
0,0,0,1,0,18,18,21,0,0,0,
0,1,0,19,24,19,19,2,21,17,1,
0,1,16,16,0,0,0,16,0,16,0,
0,17,17,1,2,19,21,2,0,19,0,
0,0,0,21,2,1,0,16,0,18,0,
19,19,0,19,1,19,0,1,0,1,1,
21,18,0,0,0,0,0,18,0,0,0,
19,2,2,0,17,2,17,17,1,1,1,
21,1,1,16,16,1,1,1,16,16,1,
0,1,1,1,0,0,0,21,0,0,0,
1,1,0,1,0,1,21,1,1,1,1,
0,0,21,2,7,2,0,0,0,0,0,
1,16,1,1,21,16,16,16,16,1,1,
0,21,0,2,0,0,0,2,0,0,0,
2,2,21,2,1,1,0,1,0,2,0,
0,0,21,1,17,17,0,0,0,1,0,
16,1,0,16,21,1,1,1,16,16,1,
21,2,0,2,0,0,0,0,0,0,0,
1,1,1,1,1,1,1,1,1,1,0,
0,0,0,1,0,0,2,2,21,1,0,
1,2,1,1,2,1,2,2,1,1,21,
1,1,1,1,1,1,1,1,1,1,21,
0,1,1,1,1,1,0,1,21,1,1,
0,0,0,2,1,1,0,0,0,2,21,
1,1,8,1,21,1,1,1,1,1,0,
1,1,1,1,21,1,1,1,1,1,0,
0,0,21,1,1,1,0,0,0,1,0,
21,1,0,1,1,1,0,1,0,1,1,
0,1,0,0,21,0,0,1,0,0,0,
1,2,1,1,2,2,2,1,1,2,0,
21,1,1,1,1,1,1,1,1,1,1,
1,2,1,1,1,2,2,0,1,2,1,
0,0,0,21,1,1,0,1,0,0,0,
17,1,17,17,1,1,0,17,21,17,1,
0,16,0,21,24,0,0,16,0,0,0,
0,1,1,1,1,1,1,1,1,1,1,
0,1,0,1,0,0,21,0,0,1,0,
0,0,0,0,0,0,0,0,0,0,0,
0,0,0,0,0,0,0,0,0,0,0,
0,0,0,0,0,0,0,0,0,0,0,
0,0,0,0,0,0,0,0,0,0,0.
[layer]
type=Tile Layer 2
data=
78,78,78,78,157,78,157,0,157,157,157,
0,0,0,235,235,0,0,0,0,117,0,
235,235,0,235,235,235,0,235,0,235,235,
171,171,85,85,171,171,171,85,0,85,171,
0,171,171,171,85,171,171,171,171,85,171,
169,169,169,169,169,169,169,169,169,0,169,
0,234,234,117,117,117,234,117,234,234,0,
156,156,0,78,156,78,156,156,78,78,156,
0,0,0,116,116,0,0,232,0,0,0,
83,167,0,167,167,167,0,167,0,83,167,
0,249,0,0,0,249,0,0,0,249,0,
0,123,247,247,0,123,247,123,123,247,0,
75,75,75,150,150,75,150,0,150,150,150,
0,225,0,0,0,0,0,225,0,0,0,
0,223,0,223,223,223,0,223,0,223,0,
161,0,80,161,161,161,161,161,80,80,161,
161,161,161,161,161,161,80,161,161,80,0,
0,160,160,160,160,80,160,160,80,160,160,
0,146,146,146,146,146,146,146,146,146,0,
0,108,0,0,0,217,108,0,0,217,0,
108,108,0,216,0,216,216,216,0,216,216,
155,155,155,155,77,155,77,0,155,155,155,
0,0,0,232,0,0,0,232,0,0,0,
154,154,0,154,0,154,154,154,0,154,154,
0,0,0,141,0,141,141,0,0,0,0,
0,208,0,208,0,208,208,208,0,104,208,
0,138,69,69,0,0,0,69,0,69,0,
0,75,75,150,150,150,0,150,0,150,0,
0,0,0,0,149,149,0,74,0,149,0,
148,148,0,148,148,148,0,148,0,148,148,
0,136,0,0,0,0,0,136,0,0,0,
135,135,135,0,67,135,67,67,135,135,135,
0,135,135,67,67,135,135,135,67,67,135,
0,145,145,145,0,0,0,0,0,0,0,
144,144,0,144,0,144,0,144,144,144,144,
0,0,0,214,0,214,0,0,0,0,0,
131,65,131,131,0,65,65,65,65,131,131,
0,0,0,130,0,0,0,130,0,0,0,
128,128,0,128,128,128,0,128,0,128,0,
0,0,0,138,69,69,0,0,0,138,0,
68,137,0,68,0,137,137,137,68,68,137,
0,136,0,136,0,0,0,0,0,0,0,
124,124,124,124,124,124,124,124,124,124,0,
0,0,0,124,0,0,124,124,0,124,0,
123,123,123,123,123,123,123,123,123,123,0,
132,132,132,132,132,132,132,132,132,132,0,
0,131,131,131,131,131,0,131,0,131,131,
0,0,0,130,130,130,0,0,0,130,0,
178,178,0,178,0,178,178,178,178,178,0,
117,117,117,117,0,117,117,117,117,117,0,
0,0,0,116,116,116,0,0,0,116,0,
0,106,0,106,106,106,0,106,0,106,106,
0,105,0,0,0,0,0,105,0,0,0,
104,104,104,104,104,104,104,104,104,104,0,
0,94,94,94,94,94,94,94,94,94,94,
93,93,93,93,93,93,93,0,93,93,93,
0,0,0,0,93,93,0,93,0,0,0,
46,92,46,46,92,92,0,46,0,46,92,
0,68,0,0,0,0,0,68,0,0,0,
0,90,90,90,90,90,90,90,90,90,90,
0,90,0,90,0,0,0,0,0,90,0,
0,0,0,0,0,0,0,0,0,0,0,
0,0,0,0,0,0,0,0,0,0,0,
0,0,0,0,0,0,0,0,0,0,0,
0,0,0,0,0,0,0,0,0,0,0.