[layer]
type=Tile Layer 1
data=
0,1,1,1,1,1,1,1,1,1,0,
0,1,0,0,21,21,21,0,0,1,0,
0,1,0,1,1,1,1,1,0,1,0,
0,1,21,1,0,0,0,1,21,1,0,
0,1,21,1,0,1,0,1,21,1,0,
0,1,21,1,0,0,0,1,21,1,0,
0,1,0,1,1,1,1,1,0,1,0,
0,1,0,0,0,21,0,0,0,1,0,
0,1,1,1,1,1,1,1,1,1,0,
0,0,0,0,0,0,0,0,0,0,0,
0,0,0,0,0,0,0,0,0,0,0,
0,0,0,0,0,0,0,0,0,0,0,
0,0,0,0,0,0,0,0,0,0,0.
[layer]
type=Tile Layer 2
data=
0,87,87,87,87,87,87,87,87,87,0,
0,87,0,0,0,0,0,0,0,87,0,
0,76,0,76,76,76,76,76,0,76,0,
0,76,0,76,0,0,0,76,0,76,0,
0,74,0,74,0,74,0,74,0,74,0,
0,72,0,72,0,0,0,72,0,72,0,
0,70,0,70,70,70,70,70,0,70,0,
0,70,0,0,0,0,0,0,0,70,0,
0,70,70,70,70,70,70,70,70,70,0,
0,0,0,0,0,0,0,0,0,0,0,
0,0,0,0,0,0,0,0,0,0,0,
0,0,0,0,0,0,0,0,0,0,0,
0,0,0,0,0,0,0,0,0,0,0.