[layer]
type=Tile Layer 1
data=
0,0,1,4,0,0,0,1,1,0,0,
0,1,17,1,0,0,3,17,21,1,0,
0,0,0,0,0,0,3,21,21,21,6,
0,0,0,0,0,0,1,21,3,1,0,
5,0,16,0,1,0,1,3,0,8,0,
1,1,1,3,3,1,1,0,0,0,0,
3,21,21,21,21,21,6,0,0,0,0,
17,0,17,1,4,0,1,0,0,0,0,
1,4,1,1,4,3,3,0,0,0,0,
0,0,0,0,0,0,0,0,0,0,0,
0,0,0,0,0,0,0,0,0,0,0,
0,0,0,0,0,0,0,0,0,0,0,
0,0,0,0,0,0,0,0,0,0,0.
[layer]
type=Tile Layer 2
data=
0,0,73,73,0,0,0,73,73,0,0,
0,73,36,73,0,0,73,36,0,73,0,
0,0,0,0,0,0,65,0,0,0,65,
0,0,0,0,0,0,62,0,62,62,0,
91,0,45,0,91,0,91,91,0,0,0,
61,61,61,61,61,61,61,0,0,0,0,
61,0,0,0,0,0,61,0,0,0,0,
28,0,28,57,57,0,57,0,0,0,0,
57,57,57,57,57,57,57,0,0,0,0,
0,0,0,0,0,0,0,0,0,0,0,
0,0,0,0,0,0,0,0,0,0,0,
0,0,0,0,0,0,0,0,0,0,0,
0,0,0,0,0,0,0,0,0,0,0.