[layer]
type=Tile Layer 1
data=
2,2,2,2,1,2,7,1,2,1,1,
2,18,18,16,18,2,1,16,0,16,1,
2,19,17,17,1,19,19,2,19,0,1,
7,18,0,1,0,0,21,18,18,18,1,
2,0,19,2,17,17,19,2,19,1,1,
0,1,16,16,18,2,18,2,2,16,1,
17,19,17,19,19,1,1,0,19,2,1,
1,16,1,16,16,16,16,1,16,1,0,
17,1,21,1,1,19,2,19,19,19,1,
18,18,0,0,0,0,0,0,21,18,18,
19,17,0,21,0,19,2,17,1,2,1,
0,16,16,16,7,1,16,1,1,1,21,
7,1,0,1,21,1,1,1,0,1,0,
1,18,0,2,0,18,1,18,1,16,21,
7,2,0,2,21,17,19,1,17,19,1,
18,18,18,16,8,1,2,18,21,18,1,
19,19,19,19,24,2,1,17,0,0,0,
2,2,2,2,1,1,2,2,21,1,1,
8,0,21,0,0,19,2,19,0,17,1,
18,18,18,2,21,16,18,18,24,1,1,
1,1,21,17,17,1,1,17,17,17,1,
18,16,2,16,2,0,16,2,18,2,1,
19,19,0,19,1,19,19,1,21,1,1,
1,1,0,1,0,7,0,0,0,1,21,
1,1,21,17,19,2,19,19,0,19,1,
0,0,21,18,1,18,18,1,0,18,1,
2,19,1,19,17,1,19,19,21,19,1,
0,21,0,2,18,18,18,16,0,1,1,
0,21,0,2,17,19,17,2,0,19,1,
0,0,21,0,0,0,0,18,18,18,1,
1,21,17,17,17,17,1,1,1,17,1,
18,0,2,21,18,16,1,18,1,0,1,
17,0,17,0,17,17,1,0,0,0,1,
1,0,16,0,16,1,1,21,16,16,1,
17,0,17,0,17,17,1,0,1,21,0,
18,16,16,21,1,18,1,18,2,2,1,
1,2,2,21,2,2,1,2,1,0,1,
18,16,16,0,18,2,2,18,1,21,1,
19,2,17,21,17,19,19,2,1,1,1,
16,0,21,0,1,16,1,16,16,0,1,
1,1,1,0,1,1,1,1,1,21,1,
2,2,2,0,0,0,21,0,0,0,2,
17,17,1,21,1,1,1,17,17,17,1,
1,1,1,0,1,0,0,0,0,21,1,
2,2,2,0,2,21,0,0,0,0,2,
1,16,16,0,1,21,16,1,16,16,1,
1,1,1,0,1,0,1,0,21,0,0,
2,1,1,0,2,0,2,2,2,21,1,
17,0,21,0,1,8,17,17,17,0,1,
1,1,1,0,1,21,1,1,1,7,1,
24,0,2,21,2,0,2,2,1,0,1,
1,0,1,0,1,21,1,1,1,0,1,
1,0,1,0,1,0,1,21,0,0,1,
1,0,1,21,2,8,2,1,2,2,1,
1,0,2,0,2,21,2,1,2,0,0,
1,21,2,0,2,2,1,1,2,0,1,
17,0,1,17,1,0,17,17,17,21,1,
1,0,1,1,1,0,1,1,1,21,0,
1,1,1,1,1,1,1,1,1,21,1,
1,0,1,1,1,0,0,0,0,21,1,
2,21,1,2,2,0,1,2,2,1,1,
1,1,1,1,1,0,1,21,1,1,1,
1,1,1,1,1,0,1,0,1,1,1,
1,1,1,1,1,0,1,1,1,1,1,
0,0,0,0,0,0,19,0,19,19,1,
1,21,1,1,1,0,1,1,1,1,1,
1,0,1,0,1,0,0,21,0,0,1,
1,21,1,7,1,1,1,1,1,1,1,
1,21,1,1,1,1,1,1,1,1,1,
0,0,21,0,1,0,1,1,1,1,1,
2,1,2,21,2,0,2,1,2,1,1,
1,21,1,0,1,0,1,1,1,1,1,
1,0,1,1,1,21,1,1,1,1,1,
1,1,1,1,1,1,1,1,1,21,1,
1,1,1,21,1,0,0,0,1,0,1,
1,1,1,21,1,0,1,1,1,0,1,
0,0,0,0,0,0,0,0,0,0,0,
0,0,0,0,0,0,0,0,0,0,0,
0,0,0,0,0,0,0,0,0,0,0,
0,0,0,0,0,0,0,0,0,0,0.
[layer]
type=Tile Layer 2
data=
210,210,210,210,210,210,0,210,210,210,210,
140,140,140,70,140,140,140,70,0,70,140,
140,140,70,70,140,140,140,140,140,0,140,
0,274,0,274,0,0,0,274,274,274,274,
128,0,128,128,64,64,128,128,128,128,128,
0,128,64,64,128,128,128,128,128,64,128,
69,139,69,139,139,139,139,0,139,139,139,
139,69,139,69,69,69,69,139,69,139,0,
69,139,0,139,139,139,139,139,139,139,139,
181,181,0,0,0,0,0,0,0,181,181,
162,81,0,0,0,162,162,81,162,162,162,
0,120,120,120,0,241,120,241,241,241,0,
0,289,0,289,0,289,289,289,0,289,0,
173,173,0,173,0,173,173,173,173,86,0,
0,258,0,258,0,129,258,258,129,258,258,
210,210,210,105,0,210,210,210,0,210,210,
259,259,259,259,0,259,259,129,0,0,0,
121,121,121,121,121,121,121,121,0,121,121,
0,0,0,0,0,280,280,280,0,140,280,
223,223,223,223,0,111,223,223,0,223,223,
130,130,0,65,65,130,130,65,65,65,130,
119,59,119,59,119,0,59,119,119,119,119,
136,136,0,136,136,136,136,136,0,136,136,
250,250,0,250,0,0,0,0,0,250,0,
145,145,0,72,145,145,145,145,0,145,145,
0,0,0,180,180,180,180,180,0,180,180,
126,126,126,126,63,126,126,126,0,126,126,
0,0,0,163,163,163,163,81,0,163,163,
0,0,0,162,81,162,81,162,0,162,162,
0,0,0,0,0,0,0,161,161,161,161,
122,0,61,61,61,61,122,122,122,61,122,
155,0,155,0,155,77,155,155,155,0,155,
86,0,86,0,86,86,172,0,0,0,172,
142,0,71,0,71,142,142,0,71,71,142,
78,0,78,0,78,78,156,0,156,0,0,
109,54,54,0,109,109,109,109,109,109,109,
134,134,134,0,134,134,134,134,134,0,134,
133,66,66,0,133,133,133,133,133,0,133,
116,116,58,0,58,116,116,116,116,116,116,
75,0,0,0,151,75,151,75,75,0,151,
120,120,120,0,120,120,120,120,120,0,120,
149,149,149,0,0,0,0,0,0,0,149,
56,56,113,0,113,113,113,56,56,56,113,
160,160,160,0,160,0,0,0,0,0,160,
158,158,158,0,158,0,0,0,0,0,158,
116,58,58,0,116,0,58,116,58,58,116,
143,143,143,0,143,0,143,0,0,0,0,
128,128,128,0,128,0,128,128,128,0,128,
115,0,0,0,231,0,115,115,115,0,231,
205,205,205,0,205,0,205,205,205,0,205,
0,0,226,0,226,0,226,226,226,0,226,
138,0,138,0,138,0,138,138,138,0,138,
137,0,137,0,137,0,137,0,0,0,137,
183,0,183,0,183,0,183,183,183,183,183,
146,0,146,0,146,0,146,146,146,0,0,
131,0,131,0,131,131,131,131,131,0,131,
65,0,130,65,130,0,65,65,65,0,130,
131,0,131,131,131,0,131,131,131,0,0,
92,92,92,92,92,92,92,92,92,0,92,
129,0,129,129,129,0,0,0,0,0,129,
112,0,112,112,112,0,112,112,112,112,112,
110,110,110,110,110,0,110,0,110,110,110,
109,109,109,109,109,0,109,0,109,109,109,
88,88,88,88,88,0,88,88,88,88,88,
0,0,0,0,0,0,126,0,126,126,126,
100,0,100,100,100,0,100,100,100,100,100,
114,0,114,0,114,0,0,0,0,0,114,
136,0,136,0,136,136,136,136,136,136,136,
79,0,79,79,79,79,79,79,79,79,79,
0,0,0,0,100,0,100,100,100,100,100,
79,79,79,0,79,0,79,79,79,79,79,
88,0,88,0,88,0,88,88,88,88,88,
78,0,78,78,78,0,78,78,78,78,78,
68,68,68,68,68,68,68,68,68,0,68,
95,95,95,0,95,0,0,0,95,0,95,
85,85,85,0,85,0,85,85,85,0,85,
0,0,0,0,0,0,0,0,0,0,0,
0,0,0,0,0,0,0,0,0,0,0,
0,0,0,0,0,0,0,0,0,0,0,
0,0,0,0,0,0,0,0,0,0,0.