[layer]
type=Tile Layer 1
data=
1,21,1,1,1,0,1,8,1,0,1,
0,0,1,1,0,0,21,0,1,0,1,
1,1,16,16,16,1,1,1,1,21,1,
0,0,7,0,1,0,0,0,0,0,1,
1,1,1,1,1,1,1,0,1,1,1,
0,21,1,0,17,0,1,0,0,0,0,
1,1,1,0,1,21,1,0,1,1,1,
0,0,0,0,1,0,21,0,1,1,1,
1,1,1,1,1,1,1,1,1,21,1,
0,0,0,0,0,0,0,0,0,0,0,
0,0,0,0,0,0,0,0,0,0,0,
0,0,0,0,0,0,0,0,0,0,0,
0,0,0,0,0,0,0,0,0,0,0.
[layer]
type=Tile Layer 2
data=
69,0,69,69,69,0,69,0,69,0,69,
0,0,45,45,0,0,0,0,45,0,45,
28,28,14,14,14,28,28,28,28,0,28,
0,0,0,0,58,0,0,0,0,0,58,
28,28,28,28,28,28,28,0,28,28,28,
0,0,39,0,19,0,39,0,0,0,0,
35,35,35,0,35,0,35,0,35,35,35,
0,0,0,0,37,0,0,0,37,37,37,
26,26,26,26,26,26,26,26,26,0,26,
0,0,0,0,0,0,0,0,0,0,0,
0,0,0,0,0,0,0,0,0,0,0,
0,0,0,0,0,0,0,0,0,0,0,
0,0,0,0,0,0,0,0,0,0,0.