[layer]
type=Tile Layer 1
data=
1,2,1,2,2,3,2,0,1,1,1,
0,0,18,0,0,0,18,0,0,0,18,
3,1,17,0,17,1,17,7,17,21,1,
2,16,16,0,18,16,18,2,2,1,1,
2,1,0,6,1,2,2,2,1,2,1,
16,6,0,16,1,16,1,16,1,1,1,
1,17,0,17,17,6,1,5,1,17,1,
18,3,5,21,1,16,18,2,2,16,1,
17,19,2,19,3,0,2,17,19,21,1,
2,0,7,0,0,0,18,4,16,21,0,
2,21,1,2,1,2,6,8,2,1,1,
18,0,0,0,18,0,0,0,21,18,1,
4,1,1,21,1,24,2,2,2,2,1,
16,1,3,0,1,16,16,16,1,16,1,
2,17,17,2,19,1,19,1,19,1,0,
7,0,0,0,21,0,16,0,0,0,16,
17,2,17,2,19,21,19,5,19,7,1,
0,0,0,0,2,0,0,2,1,21,0,
17,0,4,17,17,1,17,1,17,3,1,
2,0,2,2,2,0,0,0,0,21,0,
2,21,1,2,5,0,1,2,1,2,1,
1,0,0,0,0,21,2,2,1,0,0,
17,2,4,19,19,19,19,7,1,21,1,
16,0,0,0,21,0,0,0,16,0,0,
2,21,19,17,17,2,17,8,3,2,1,
0,21,18,0,0,0,18,0,0,0,0,
19,3,1,0,6,0,2,19,19,17,1,
21,0,18,0,18,0,0,0,0,0,0,
2,0,4,21,3,2,2,4,2,1,1,
18,0,18,0,18,0,0,0,21,0,0,
17,0,1,0,17,21,4,17,1,17,1,
18,0,0,0,18,0,0,0,21,0,0,
17,1,1,1,17,21,6,17,17,17,1,
0,24,0,18,1,0,18,0,21,0,0,
2,21,19,19,1,0,17,0,6,19,1,
5,1,3,0,0,21,1,0,0,8,1,
1,1,17,24,3,17,17,17,6,21,1,
0,21,2,0,3,2,2,0,0,0,1,
2,0,2,21,1,0,2,0,2,1,1,
2,0,2,0,0,0,2,21,0,0,0,
1,0,17,17,4,21,17,1,4,17,1,
1,21,0,0,5,0,0,0,0,0,0,
1,3,1,24,1,1,3,1,1,3,1,
0,0,1,0,21,1,3,0,0,0,1,
17,0,1,0,17,17,17,0,4,21,1,
0,0,18,0,0,0,16,0,2,0,0,
4,0,6,1,1,21,1,0,1,1,1,
6,0,1,4,1,21,0,0,0,1,1,
1,0,5,21,3,1,6,1,1,1,1,
0,21,16,0,0,0,0,0,16,0,0,
1,1,1,0,1,3,1,21,5,0,1,
0,0,21,0,16,16,1,0,1,0,0,
19,2,17,1,19,0,19,21,2,17,1,
0,0,0,18,1,0,7,0,2,16,21,
2,21,1,2,1,0,2,2,4,1,1,
16,1,0,1,16,3,4,16,16,1,1,
1,4,1,1,1,21,1,3,5,1,1,
1,0,1,0,0,21,3,3,1,0,0,
1,0,1,0,3,1,4,0,1,21,1,
0,0,1,21,0,0,5,0,1,0,0,
1,6,1,1,6,21,1,1,6,1,1,
0,0,0,0,1,0,6,0,0,21,0,
1,2,2,21,2,0,1,0,1,2,1,
0,0,0,0,2,1,2,21,0,0,1,
1,3,1,24,1,1,4,1,3,21,1,
0,0,5,1,1,0,0,7,0,0,1,
0,0,0,0,0,0,0,0,0,0,0,
0,0,0,0,0,0,0,0,0,0,0,
0,0,0,0,0,0,0,0,0,0,0,
0,0,0,0,0,0,0,0,0,0,0.
[layer]
type=Tile Layer 2
data=
166,166,166,166,166,166,166,0,166,166,166,
0,0,166,0,0,0,166,0,0,0,166,
270,270,135,0,135,270,135,0,135,0,270,
179,89,89,0,179,89,179,179,179,179,179,
179,179,0,179,179,179,179,179,179,179,179,
82,165,0,82,165,82,165,82,165,165,165,
165,82,0,82,82,165,165,165,165,82,165,
165,165,165,0,165,82,165,165,165,82,165,
89,178,178,178,178,0,178,89,178,0,178,
264,0,0,0,0,0,264,264,132,0,0,
262,0,262,262,262,262,262,0,262,262,262,
160,0,0,0,160,0,0,0,0,160,160,
238,238,238,0,238,0,238,238,238,238,238,
79,158,158,0,158,79,79,79,158,79,158,
172,86,86,172,172,172,172,172,172,172,0,
0,0,0,0,0,0,129,0,0,0,129,
127,255,127,255,255,0,255,255,255,0,255,
0,0,0,0,156,0,0,156,156,0,0,
77,0,155,77,77,155,77,155,77,155,155,
155,0,155,155,155,0,0,0,0,0,0,
167,0,167,167,167,0,167,167,167,167,167,
166,0,0,0,0,0,166,166,166,0,0,
123,246,246,246,246,246,246,0,246,0,246,
75,0,0,0,0,0,0,0,75,0,0,
223,0,223,111,111,223,111,0,223,223,223,
0,0,148,0,0,0,148,0,0,0,0,
160,160,160,0,160,0,160,160,160,80,160,
0,0,160,0,160,0,0,0,0,0,0,
158,0,158,0,158,158,158,158,158,158,158,
145,0,145,0,145,0,0,0,0,0,0,
72,0,144,0,72,0,144,72,144,72,144,
143,0,0,0,143,0,0,0,0,0,0,
77,154,154,154,77,0,154,77,77,77,154,
0,0,0,228,228,0,228,0,0,0,0,
151,0,151,151,151,0,75,0,151,151,151,
207,207,207,0,0,0,207,0,0,0,207,
205,205,102,0,205,102,102,102,205,0,205,
0,0,136,0,136,136,136,0,0,0,136,
146,0,146,0,146,0,146,0,146,146,146,
145,0,145,0,0,0,145,0,0,0,0,
144,0,72,72,144,0,72,144,144,72,144,
132,0,0,0,132,0,0,0,0,0,0,
196,196,196,0,196,196,196,196,196,196,196,
0,0,131,0,0,131,131,0,0,0,131,
70,0,140,0,70,70,70,0,140,0,140,
0,0,139,0,0,0,69,0,139,0,0,
139,0,139,139,139,0,139,0,139,139,139,
127,0,127,127,127,0,0,0,0,127,127,
126,0,126,0,126,126,126,126,126,126,126,
0,0,62,0,0,0,0,0,62,0,0,
134,134,134,0,134,134,134,0,134,0,134,
0,0,0,0,66,66,133,0,133,0,0,
132,132,66,132,132,0,132,0,132,66,132,
0,0,0,181,181,0,0,0,181,90,0,
120,0,120,120,120,0,120,120,120,120,120,
59,118,0,118,59,118,118,59,59,118,118,
109,109,109,109,109,0,109,109,109,109,109,
108,0,108,0,0,0,108,108,108,0,0,
107,0,107,0,107,107,107,0,107,0,107,
0,0,96,0,0,0,96,0,96,0,0,
95,95,95,95,95,0,95,95,95,95,95,
0,0,0,0,94,0,94,0,0,0,0,
93,93,93,0,93,0,93,0,93,93,93,
0,0,0,0,92,92,92,0,0,0,92,
136,136,136,0,136,136,136,136,136,0,136,
0,0,136,136,136,0,0,0,0,0,136,
0,0,0,0,0,0,0,0,0,0,0,
0,0,0,0,0,0,0,0,0,0,0,
0,0,0,0,0,0,0,0,0,0,0,
0,0,0,0,0,0,0,0,0,0,0.