[layer]
type=Tile Layer 1
data=
0,1,1,1,1,1,0,1,0,0,21,
1,1,1,1,1,1,1,1,1,1,1,
0,0,0,21,1,1,1,1,0,0,0,
0,0,0,21,0,1,1,1,0,0,1,
1,0,0,0,1,0,0,0,0,1,0,
21,0,0,1,0,0,1,0,1,1,1,
21,0,0,0,1,0,0,0,1,1,1,
21,0,0,0,0,1,1,1,1,1,0,
0,0,0,21,0,1,1,1,1,0,0,
0,0,0,0,0,0,0,0,0,0,0,
0,0,0,0,0,0,0,0,0,0,0,
0,0,0,0,0,0,0,0,0,0,0,
0,0,0,0,0,0,0,0,0,0,0.
[layer]
type=Tile Layer 2
data=
0,46,46,46,46,46,0,46,0,0,0,
27,27,27,27,27,27,27,27,27,27,27,
0,0,0,0,40,40,40,40,0,0,0,
0,0,0,0,0,40,40,40,0,0,40,
39,0,0,0,39,0,0,0,0,39,0,
0,0,0,39,0,0,39,0,39,39,39,
0,0,0,0,38,0,0,0,38,38,38,
0,0,0,0,0,37,37,37,37,37,0,
0,0,0,0,0,37,37,37,37,0,0,
0,0,0,0,0,0,0,0,0,0,0,
0,0,0,0,0,0,0,0,0,0,0,
0,0,0,0,0,0,0,0,0,0,0,
0,0,0,0,0,0,0,0,0,0,0.