[layer]
type=Tile Layer 1
data=
0,1,24,0,0,21,0,0,1,1,1,
0,1,1,1,0,0,21,1,1,1,0,
21,1,1,1,0,0,0,0,1,1,1,
1,0,1,1,0,2,0,0,2,0,1,
0,1,0,1,0,21,0,0,0,0,1,
1,0,24,0,1,0,0,1,0,0,21,
1,2,0,0,0,0,21,2,0,0,1,
0,0,1,1,0,1,1,0,0,21,0,
0,1,1,1,1,1,1,1,1,0,21,
1,1,1,1,1,0,1,1,1,1,1,
0,0,1,1,1,1,0,21,1,0,1,
0,0,0,0,0,0,0,0,0,0,0,
0,0,0,0,0,0,0,0,0,0,0,
0,0,0,0,0,0,0,0,0,0,0,
0,0,0,0,0,0,0,0,0,0,0.
[layer]
type=Tile Layer 2
data=
0,88,0,0,0,0,0,0,88,88,88,
0,53,53,53,0,0,0,53,53,53,0,
0,52,52,52,0,0,0,0,52,52,52,
51,0,51,51,0,51,0,0,51,0,51,
0,46,0,46,0,0,0,0,0,0,46,
67,0,0,0,67,0,0,67,0,0,0,
44,44,0,0,0,0,0,44,0,0,44,
0,0,43,43,0,43,43,0,0,0,0,
0,38,38,38,38,38,38,38,38,0,0,
29,29,29,29,29,0,29,29,29,29,29,
0,0,41,41,41,41,0,0,41,0,41,
0,0,0,0,0,0,0,0,0,0,0,
0,0,0,0,0,0,0,0,0,0,0,
0,0,0,0,0,0,0,0,0,0,0,
0,0,0,0,0,0,0,0,0,0,0.