[layer]
type=Tile Layer 1
data=
0,1,3,1,5,1,21,0,0,0,1,
0,1,6,21,3,1,0,0,1,0,1,
0,5,0,0,0,21,5,1,1,0,1,
0,0,1,0,0,3,1,21,1,4,1,
1,5,1,1,0,0,0,0,21,3,1,
6,1,0,0,5,1,0,1,21,0,1,
0,1,0,6,0,1,5,1,0,0,1,
0,5,1,1,3,1,21,4,0,1,1,
1,6,0,0,0,0,21,0,5,1,1,
0,1,0,1,1,4,21,0,0,4,1,
0,0,3,1,1,21,0,1,6,1,1,
0,1,1,1,21,0,5,1,6,0,1,
3,3,1,21,0,1,5,1,1,0,1,
0,1,21,1,5,3,0,1,0,0,1,
21,3,1,0,5,1,1,6,1,1,1,
21,4,4,1,0,0,1,1,3,1,1,
21,1,0,5,1,0,0,4,0,0,0,
0,0,0,0,0,0,0,0,0,0,0,
0,0,0,0,0,0,0,0,0,0,0,
0,0,0,0,0,0,0,0,0,0,0,
0,0,0,0,0,0,0,0,0,0,0.
[layer]
type=Tile Layer 2
data=
0,113,113,113,113,113,0,0,0,0,113,
0,122,122,0,122,122,0,0,122,0,122,
0,120,0,0,0,0,120,120,120,0,120,
0,0,119,0,0,119,119,0,119,119,119,
109,109,109,109,0,0,0,0,0,109,109,
108,108,0,0,108,108,0,108,0,0,108,
0,107,0,107,0,107,107,107,0,0,107,
0,98,98,98,98,98,0,98,0,98,98,
97,97,0,0,0,0,0,0,97,97,97,
0,96,0,96,96,96,0,0,0,96,96,
0,0,86,86,86,0,0,86,86,86,86,
0,85,85,85,0,0,85,85,85,0,85,
84,84,84,0,0,84,84,84,84,0,84,
0,83,0,83,83,83,0,83,0,0,83,
0,82,82,0,82,82,82,82,82,82,82,
0,81,81,81,0,0,81,81,81,81,81,
0,80,0,80,80,0,0,80,0,0,0,
0,0,0,0,0,0,0,0,0,0,0,
0,0,0,0,0,0,0,0,0,0,0,
0,0,0,0,0,0,0,0,0,0,0,
0,0,0,0,0,0,0,0,0,0,0.