[layer]
type=Tile Layer 1
data=
0,19,0,19,0,0,0,24,0,0,0,
18,16,2,1,1,18,16,0,18,18,1,
0,19,0,19,0,0,0,0,8,0,21,
18,1,1,16,2,18,2,0,16,18,1,
2,1,2,2,2,1,2,1,0,2,1,
2,2,1,1,2,0,1,2,2,1,1,
19,19,19,2,17,1,0,1,1,19,1,
1,16,16,16,1,1,16,16,0,1,1,
0,19,0,0,0,21,8,19,0,0,0,
1,18,0,18,1,18,24,18,21,18,1,
0,0,8,19,0,0,21,19,0,0,0,
16,16,16,1,21,16,24,1,16,16,1,
0,0,0,0,0,19,0,0,21,19,0,
2,1,2,2,2,1,1,2,21,1,7,
0,21,0,19,19,8,0,0,0,19,0,
2,16,8,16,18,18,21,18,2,1,1,
0,19,0,24,0,17,2,19,21,0,0,
21,16,1,16,0,1,16,16,24,16,1,
0,19,21,0,0,19,0,8,0,19,0,
18,18,0,1,2,16,0,2,16,1,21,
0,2,0,21,0,1,24,2,2,0,0,
0,1,1,1,21,1,8,1,1,1,1,
0,0,2,2,0,2,0,21,0,0,0,
18,18,16,2,21,18,2,18,16,1,1,
17,19,19,1,0,19,19,1,19,2,1,
0,18,18,0,0,18,0,18,0,0,0,
21,17,17,17,1,1,0,17,0,17,1,
0,0,0,21,0,1,0,1,0,0,0,
1,19,1,1,21,19,19,19,19,19,1,
21,2,0,1,2,2,1,1,0,2,1,
0,19,0,21,24,17,19,0,0,2,0,
1,18,2,16,21,18,2,18,1,16,0,
0,2,19,19,17,17,2,1,2,19,1,
21,16,16,1,16,16,1,1,7,16,1,
0,19,0,0,0,0,0,0,0,19,0,
0,2,0,16,16,18,2,2,16,1,21,
17,19,19,19,21,19,0,19,1,2,1,
21,0,0,0,0,18,0,0,16,2,0,
0,2,0,1,1,19,17,19,1,19,21,
21,1,18,1,2,16,1,18,18,18,1,
1,1,1,1,1,1,21,1,1,1,1,
21,0,0,1,0,0,0,1,1,1,0,
1,1,1,1,1,1,0,1,1,1,1,
0,1,0,1,0,1,0,21,0,1,0,
2,1,0,2,21,2,0,2,0,2,1,
1,1,1,1,1,1,0,1,1,1,1,
1,17,17,17,17,1,17,17,21,1,1,
1,1,1,1,1,1,21,1,0,1,0,
0,0,19,19,0,0,0,19,0,19,21,
1,1,1,1,21,1,1,1,0,1,1,
0,21,0,0,0,1,0,0,0,1,0,
1,1,1,1,1,1,0,1,1,1,21,
21,0,0,0,0,17,0,1,17,0,0,
1,1,1,1,21,1,0,1,1,1,1,
0,0,1,1,21,0,0,1,0,0,0,
0,1,16,16,16,1,16,1,21,1,0,
1,2,2,1,0,2,1,2,1,2,21,
21,0,0,0,0,1,0,0,1,1,0,
1,1,1,1,1,1,1,1,1,0,1,
1,16,0,16,21,16,16,1,1,16,1,
0,0,0,1,0,0,0,1,1,21,0,
1,1,1,1,1,1,0,1,1,1,21,
1,1,1,1,1,1,1,0,1,1,1,
21,1,1,1,1,1,1,1,24,1,1,
0,0,0,1,1,1,0,1,0,21,0,
1,1,0,1,0,1,0,1,1,1,21,
0,1,0,2,0,2,8,2,1,2,21,
16,18,0,18,21,18,0,18,24,2,1,
0,0,0,1,0,21,0,1,0,0,0,
2,2,2,1,0,2,2,1,21,2,1,
0,0,1,1,0,1,1,1,0,0,21,
0,16,1,1,0,16,0,16,21,16,0,
7,17,0,0,0,17,21,1,0,17,0,
0,1,21,2,1,2,24,2,0,2,1,
0,1,0,0,0,1,0,0,0,0,21,
21,1,1,1,0,1,1,1,1,1,1,
0,0,0,0,0,0,0,0,0,0,0,
0,0,0,0,0,0,0,0,0,0,0,
0,0,0,0,0,0,0,0,0,0,0,
0,0,0,0,0,0,0,0,0,0,0.
[layer]
type=Tile Layer 2
data=
0,304,0,304,0,0,0,0,0,0,0,
203,101,203,203,203,203,101,0,203,203,203,
0,304,0,304,0,0,0,0,0,0,0,
186,186,186,93,186,186,186,0,93,186,186,
186,186,186,186,186,186,186,186,0,186,186,
186,186,186,186,186,0,186,186,186,186,186,
202,202,202,202,101,202,0,202,202,202,202,
202,101,101,101,202,202,101,101,0,202,202,
0,303,0,0,0,0,0,303,0,0,0,
276,276,0,276,276,276,0,276,0,276,276,
0,0,0,274,0,0,0,274,0,0,0,
136,136,136,273,0,136,0,273,136,136,273,
0,0,0,0,0,197,0,0,0,197,0,
294,294,294,294,294,294,294,294,0,294,0,
0,0,0,291,291,0,0,0,0,291,0,
267,133,0,133,267,267,0,267,267,267,267,
0,265,0,0,0,132,265,265,0,0,0,
0,132,264,132,0,264,132,132,0,132,264,
0,285,0,0,0,285,0,0,0,285,0,
188,188,0,188,188,94,0,188,94,188,0,
0,280,0,0,0,280,0,280,280,0,0,
0,256,256,256,0,256,0,256,256,256,256,
0,0,170,170,0,170,0,0,0,0,0,
169,169,84,169,0,169,169,169,84,169,169,
91,182,182,182,0,182,182,182,182,182,182,
0,182,182,0,0,182,0,182,0,0,0,
0,91,91,91,182,182,0,91,0,91,182,
0,0,0,0,0,167,0,167,0,0,0,
166,166,166,166,0,166,166,166,166,166,166,
0,165,0,165,165,165,165,165,0,165,165,
0,267,0,0,0,133,267,0,0,267,0,
176,176,176,88,0,176,176,176,176,88,0,
0,175,175,175,87,87,175,175,175,175,175,
0,120,120,241,120,120,241,241,0,120,241,
0,160,0,0,0,0,0,0,0,160,0,
0,160,0,80,80,160,160,160,80,160,0,
86,173,173,173,0,173,0,173,173,173,173,
0,0,0,0,0,172,0,0,86,172,0,
0,170,0,170,170,170,85,170,170,170,0,
0,156,156,156,156,78,156,156,156,156,156,
155,155,155,155,155,155,0,155,155,155,155,
0,0,0,154,0,0,0,154,154,154,0,
166,166,166,166,166,166,0,166,166,166,166,
0,166,0,166,0,166,0,0,0,166,0,
164,164,0,164,0,164,0,164,0,164,164,
150,150,150,150,150,150,0,150,150,150,150,
150,75,75,75,75,150,75,75,0,150,150,
149,149,149,149,149,149,0,149,0,149,0,
0,0,161,161,0,0,0,161,0,161,0,
160,160,160,160,0,160,160,160,0,160,160,
0,0,0,0,0,158,0,0,0,158,0,
145,145,145,145,145,145,0,145,145,145,0,
0,0,0,0,0,72,0,144,72,0,0,
143,143,143,143,0,143,0,143,143,143,143,
0,0,154,154,0,0,0,154,0,0,0,
0,152,76,76,76,152,76,152,0,152,0,
151,151,151,151,0,151,151,151,151,151,0,
0,0,0,0,0,138,0,0,138,138,0,
137,137,137,137,137,137,137,137,137,0,137,
137,68,0,68,0,68,68,137,137,68,137,
0,0,0,148,0,0,0,148,148,0,0,
146,146,146,146,146,146,0,146,146,146,0,
145,145,145,145,145,145,145,0,145,145,145,
0,201,201,201,201,201,201,201,0,201,201,
0,0,0,133,133,133,0,133,0,0,0,
132,132,0,132,0,132,0,132,132,132,0,
0,180,0,180,0,180,0,180,180,180,0,
89,178,0,178,0,178,0,178,0,178,178,
0,0,0,118,0,0,0,118,0,0,0,
106,106,106,106,0,106,106,106,0,106,106,
0,0,105,105,0,105,105,105,0,0,0,
0,52,104,104,0,52,0,52,0,52,0,
0,77,0,0,0,77,0,154,0,77,0,
0,153,0,153,153,153,0,153,0,153,153,
0,101,0,0,0,101,0,0,0,0,0,
0,100,100,100,0,100,100,100,100,100,100,
0,0,0,0,0,0,0,0,0,0,0,
0,0,0,0,0,0,0,0,0,0,0,
0,0,0,0,0,0,0,0,0,0,0,
0,0,0,0,0,0,0,0,0,0,0.