[layer]
type=Tile Layer 1
data=
1,0,21,0,3,0,3,0,21,0,1,
3,3,21,4,5,0,4,3,21,4,1,
1,3,1,1,5,0,1,4,1,1,1,
0,1,4,6,0,0,0,1,1,1,0,
0,5,4,1,0,0,0,4,1,6,0,
1,0,21,0,4,0,4,0,21,0,1,
1,0,21,0,5,0,3,0,21,0,1,
3,3,21,4,5,0,3,3,21,4,1,
4,1,1,1,1,0,3,1,4,1,1,
0,0,0,0,0,0,0,0,0,0,0,
0,0,0,0,0,0,0,0,0,0,0,
0,0,0,0,0,0,0,0,0,0,0,
0,0,0,0,0,0,0,0,0,0,0.
[layer]
type=Tile Layer 2
data=
97,0,0,0,97,0,97,0,0,0,97,
95,95,0,95,95,0,95,95,0,95,95,
76,76,76,76,76,0,76,76,76,76,76,
0,84,84,84,0,0,0,84,84,84,0,
0,84,84,84,0,0,0,84,84,84,0,
84,0,0,0,84,0,84,0,0,0,84,
82,0,0,0,82,0,82,0,0,0,82,
80,80,0,80,80,0,80,80,0,80,80,
71,71,71,71,71,0,71,71,71,71,71,
0,0,0,0,0,0,0,0,0,0,0,
0,0,0,0,0,0,0,0,0,0,0,
0,0,0,0,0,0,0,0,0,0,0,
0,0,0,0,0,0,0,0,0,0,0.