[layer]
type=Tile Layer 1
data=
0,1,0,0,0,1,0,2,7,2,0,
0,1,2,2,2,1,0,1,7,2,0,
0,2,1,1,2,1,21,2,7,2,0,
2,1,2,1,2,1,2,1,1,0,1,
8,1,1,1,1,1,0,1,0,1,21,
21,1,1,1,1,1,0,1,7,1,1,
2,2,2,2,1,1,8,2,21,1,1,
0,2,0,21,0,0,0,2,8,2,1,
7,2,1,1,2,2,21,1,0,2,1,
1,1,1,1,1,1,1,0,1,1,1,
1,2,1,2,2,2,1,2,1,1,0,
2,2,1,2,1,2,0,1,0,21,0,
1,1,21,1,1,1,1,1,0,1,1,
2,0,2,2,2,1,1,1,1,2,1,
21,7,0,2,1,2,1,1,0,1,0,
0,21,7,2,1,1,1,1,0,2,0,
2,1,1,2,2,1,2,1,21,1,7,
21,1,1,1,2,2,2,2,1,1,1,
1,1,1,1,1,1,1,1,8,21,0,
7,1,1,1,0,1,1,1,0,0,21,
21,2,1,2,0,2,1,1,1,2,1,
0,0,21,0,0,1,2,2,0,1,1,
1,2,1,1,0,2,2,1,2,2,1,
2,2,1,1,1,1,2,1,0,2,1,
2,2,2,2,21,1,1,1,0,2,1,
2,2,2,2,0,0,0,0,0,21,0,
2,2,0,0,0,0,0,21,0,2,2,
1,2,2,1,2,2,1,1,0,2,1,
0,0,0,1,1,2,1,2,0,0,21,
1,1,1,1,1,1,1,1,8,0,21,
1,1,1,1,1,21,1,1,1,1,1,
2,2,2,2,1,0,1,0,0,21,0,
1,2,2,2,1,21,1,2,1,2,1,
1,1,1,21,1,1,1,1,1,1,1,
1,0,0,0,1,0,1,1,1,0,0,
1,1,1,1,1,21,1,1,1,1,1,
0,0,21,0,0,0,1,1,1,0,1,
2,7,0,0,0,0,2,1,2,0,1,
1,0,0,21,0,0,1,1,1,0,1,
1,21,1,1,1,1,1,1,1,0,1,
1,1,1,21,1,1,1,0,1,0,1,
21,0,1,0,1,1,1,0,1,0,0,
0,0,1,0,1,1,1,21,1,1,1,
0,0,1,21,1,0,0,0,1,1,1,
1,1,1,21,1,1,1,0,1,1,1,
1,1,1,1,1,1,1,1,0,1,1,
1,1,1,21,1,1,1,1,1,1,1,
2,2,2,21,0,0,2,0,0,0,0,
1,1,1,1,1,21,1,0,1,1,1,
0,0,21,0,1,0,1,0,1,1,1,
2,7,2,1,1,21,2,0,1,2,1,
1,0,1,0,1,21,1,0,1,0,0,
1,21,1,0,1,0,1,1,1,1,1,
0,0,1,0,0,21,1,1,1,1,1,
0,21,1,1,1,1,1,1,1,1,1,
0,0,1,0,21,0,1,1,1,1,1,
21,0,1,1,1,24,1,1,1,1,1,
2,0,0,0,21,0,2,1,1,2,1,
1,0,21,0,0,0,1,1,1,1,1,
1,21,0,0,0,0,1,1,1,1,1,
1,0,0,21,0,0,1,1,1,1,1,
0,0,0,0,0,0,0,0,0,0,0,
0,0,0,0,0,0,0,0,0,0,0,
0,0,0,0,0,0,0,0,0,0,0,
0,0,0,0,0,0,0,0,0,0,0.
[layer]
type=Tile Layer 2
data=
0,234,0,0,0,234,0,234,0,234,0,
0,234,234,234,234,234,0,234,0,234,0,
0,234,234,234,234,234,0,234,0,234,0,
119,119,119,119,119,119,119,119,119,0,119,
0,253,253,253,253,253,0,253,0,253,0,
0,226,226,226,226,226,0,226,0,226,226,
183,183,183,183,183,183,0,183,0,183,183,
0,228,0,0,0,0,0,228,0,228,228,
0,204,204,204,204,204,0,204,0,204,204,
115,115,115,115,115,115,115,0,115,115,115,
115,115,115,115,115,115,115,115,115,115,0,
163,163,163,163,163,163,0,163,0,0,0,
119,119,0,119,119,119,119,119,0,119,119,
104,0,104,104,104,104,104,104,104,104,104,
0,0,0,222,222,222,222,222,0,222,0,
0,0,0,240,240,240,240,240,0,240,0,
190,190,190,190,190,190,190,190,0,190,0,
0,110,110,110,110,110,110,110,110,110,110,
193,193,193,193,193,193,193,193,0,0,0,
0,213,213,213,0,213,213,213,0,0,0,
0,114,114,114,0,114,114,114,114,114,114,
0,0,0,0,0,152,152,152,0,152,152,
107,107,107,107,0,107,107,107,107,107,107,
107,107,107,107,107,107,107,107,0,107,107,
111,111,111,111,0,111,111,111,0,111,111,
138,138,138,138,0,0,0,0,0,0,0,
137,137,0,0,0,0,0,0,0,137,137,
104,104,104,104,104,104,104,104,0,104,104,
0,0,0,148,148,148,148,148,0,0,0,
198,198,198,198,198,198,198,198,0,0,0,
94,94,94,94,94,0,94,94,94,94,94,
132,132,132,132,132,0,132,0,0,0,0,
93,93,93,93,93,0,93,93,93,93,93,
100,100,100,0,100,100,100,100,100,100,100,
140,0,0,0,140,0,140,140,140,0,0,
98,98,98,98,98,0,98,98,98,98,98,
0,0,0,0,0,0,128,128,128,0,128,
190,0,0,0,0,0,190,190,190,0,190,
127,0,0,0,0,0,127,127,127,0,127,
109,0,109,109,109,109,109,109,109,0,109,
122,122,122,0,122,122,122,0,122,0,122,
0,0,134,0,134,134,134,0,134,0,0,
0,0,122,0,122,122,122,0,122,122,122,
0,0,121,0,121,0,0,0,121,121,121,
96,96,96,0,96,96,96,0,96,96,96,
91,91,91,91,91,91,91,91,0,91,91,
91,91,91,0,91,91,91,91,91,91,91,
128,128,128,0,0,0,128,0,0,0,0,
94,94,94,94,94,0,94,0,94,94,94,
0,0,0,0,116,0,116,0,116,116,116,
154,0,154,154,154,0,154,0,154,154,154,
104,0,104,0,104,0,104,0,104,0,0,
93,0,93,0,93,0,93,93,93,93,93,
0,0,102,0,0,0,102,102,102,102,102,
0,0,73,73,73,73,73,73,73,73,73,
0,0,90,0,0,0,90,90,90,90,90,
0,0,120,120,120,0,120,120,120,120,120,
88,0,0,0,0,0,88,88,88,88,88,
87,0,0,0,0,0,87,87,87,87,87,
86,0,0,0,0,0,86,86,86,86,86,
85,0,0,0,0,0,85,85,85,85,85,
0,0,0,0,0,0,0,0,0,0,0,
0,0,0,0,0,0,0,0,0,0,0,
0,0,0,0,0,0,0,0,0,0,0,
0,0,0,0,0,0,0,0,0,0,0.