[layer]
type=Tile Layer 1
data=
0,0,1,1,1,0,1,2,2,24,0,
0,1,1,0,0,1,1,1,0,0,0,
1,1,21,21,21,1,1,1,0,0,1,
0,1,1,1,21,1,1,1,1,1,1,
0,0,0,1,21,1,2,2,1,1,1,
0,24,0,1,1,21,1,2,1,1,0,
0,0,1,1,1,1,21,21,21,0,1,
0,1,1,1,1,1,1,1,21,0,1,
0,0,0,1,1,0,0,1,21,1,1,
0,0,0,0,0,0,0,0,0,0,0,
0,0,0,0,0,0,0,0,0,0,0,
0,0,0,0,0,0,0,0,0,0,0,
0,0,0,0,0,0,0,0,0,0,0.
[layer]
type=Tile Layer 2
data=
0,0,130,130,130,0,130,130,130,0,0,
0,87,87,0,0,87,87,87,0,0,0,
78,78,0,0,0,78,78,78,0,0,78,
0,76,76,76,0,76,76,76,76,76,76,
0,0,0,75,0,75,75,75,75,75,75,
0,0,0,111,111,0,111,111,111,111,0,
0,0,73,73,73,73,0,0,0,0,73,
0,70,70,70,70,70,70,70,0,0,70,
0,0,0,69,69,0,0,69,0,69,69,
0,0,0,0,0,0,0,0,0,0,0,
0,0,0,0,0,0,0,0,0,0,0,
0,0,0,0,0,0,0,0,0,0,0,
0,0,0,0,0,0,0,0,0,0,0.