[layer]
type=Tile Layer 1
data=
0,1,0,1,1,1,1,1,0,1,21,
0,1,0,0,1,1,1,0,0,1,21,
0,1,0,0,0,0,0,0,0,1,21,
0,1,1,1,1,1,1,1,1,1,21,
0,0,0,0,0,0,0,0,0,0,0,
21,1,1,1,1,1,1,1,1,1,0,
21,1,0,0,0,0,0,0,0,1,0,
21,1,0,0,1,1,1,0,0,1,0,
21,1,0,0,1,1,1,0,0,1,0,
0,0,0,0,0,0,0,0,0,0,0,
0,0,0,0,0,0,0,0,0,0,0,
0,0,0,0,0,0,0,0,0,0,0,
0,0,0,0,0,0,0,0,0,0,0.
[layer]
type=Tile Layer 2
data=
0,53,0,53,53,53,53,53,0,53,0,
0,52,0,0,52,52,52,0,0,52,0,
0,46,0,0,0,0,0,0,0,46,0,
0,36,36,36,36,36,36,36,36,36,0,
0,0,0,0,0,0,0,0,0,0,0,
0,35,35,35,35,35,35,35,35,35,0,
0,43,0,0,0,0,0,0,0,43,0,
0,42,0,0,42,42,42,0,0,42,0,
0,41,0,0,41,41,41,0,0,41,0,
0,0,0,0,0,0,0,0,0,0,0,
0,0,0,0,0,0,0,0,0,0,0,
0,0,0,0,0,0,0,0,0,0,0,
0,0,0,0,0,0,0,0,0,0,0.