[layer]
type=Tile Layer 1
data=
6,0,0,0,0,1,1,9,1,1,1,
0,0,1,1,1,1,1,1,1,1,1,
0,0,0,0,0,1,1,0,0,0,1,
1,1,1,3,0,1,1,1,1,1,1,
1,1,1,1,0,0,0,0,1,9,1,
1,0,0,0,0,1,3,0,5,1,1,
1,1,1,1,1,1,1,0,0,5,1,
0,1,1,9,1,1,1,0,0,0,0,
0,0,1,1,1,0,0,0,0,0,0,
0,0,0,0,0,0,0,0,0,0,0,
0,0,0,0,0,0,0,0,0,0,0.
[layer]
type=Tile Layer 2
data=
60,0,0,0,0,42,30,30,30,30,42,
0,0,33,24,24,24,24,24,24,24,33,
0,0,0,0,0,42,42,0,0,0,60,
29,21,21,29,0,29,21,21,21,21,29,
42,30,30,42,0,0,0,0,42,30,42,
60,0,0,0,0,42,42,0,42,30,42,
33,24,24,24,24,24,33,0,0,33,33,
0,60,60,60,60,60,60,0,0,0,0,
0,0,42,30,42,0,0,0,0,0,0,
0,0,0,0,0,0,0,0,0,0,0,
0,0,0,0,0,0,0,0,0,0,0.