[layer]
type=Tile Layer 1
data=
0,16,1,0,1,1,24,4,16,21,1,
0,1,0,17,17,0,1,5,21,3,1,
0,0,1,1,21,16,4,24,6,1,0,
0,17,1,21,1,17,0,1,4,0,1,
0,3,0,1,1,0,1,1,21,3,1,
0,0,1,1,21,6,1,0,1,5,0,
0,6,1,0,1,3,21,1,1,0,1,
5,1,0,17,1,21,5,17,0,1,1,
1,21,1,1,0,1,1,0,3,6,0,
1,6,21,1,1,0,1,1,0,6,0,
0,1,5,21,1,1,0,3,1,0,0,
1,21,1,1,0,1,1,0,6,4,0,
1,1,21,1,1,0,6,6,0,1,0,
0,1,1,0,4,1,7,5,1,21,0,
16,0,1,1,21,16,1,0,4,1,0,
1,1,21,1,6,0,1,3,0,1,0,
21,1,1,0,1,3,0,5,1,0,0,
1,0,3,1,0,1,3,0,1,1,21,
6,1,0,1,6,0,1,1,0,1,21,
0,0,0,0,0,21,0,0,0,0,0,
0,0,0,0,0,0,0,0,0,0,0,
0,0,0,0,0,0,0,0,0,0,0,
0,0,0,0,0,0,0,0,0,0,0.
[layer]
type=Tile Layer 2
data=
0,69,138,0,138,138,0,138,69,0,138,
0,90,0,45,45,0,90,90,0,90,90,
0,0,133,133,0,66,133,0,133,133,0,
0,48,96,0,96,48,0,96,96,0,96,
0,95,0,95,95,0,95,95,0,95,95,
0,0,94,94,0,94,94,0,94,94,0,
0,85,85,0,85,85,0,85,85,0,85,
84,84,0,42,84,0,84,42,0,84,84,
83,0,83,83,0,83,83,0,83,83,0,
75,75,0,75,75,0,75,75,0,75,0,
0,74,74,0,74,74,0,74,74,0,0,
73,0,73,73,0,73,73,0,73,73,0,
65,65,0,65,65,0,65,65,0,65,0,
0,96,96,0,96,96,0,96,96,0,0,
31,0,63,63,0,31,63,0,63,63,0,
62,62,0,62,62,0,62,62,0,62,0,
0,61,61,0,61,61,0,61,61,0,0,
60,0,60,60,0,60,60,0,60,60,0,
59,59,0,59,59,0,59,59,0,59,0,
0,0,0,0,0,0,0,0,0,0,0,
0,0,0,0,0,0,0,0,0,0,0,
0,0,0,0,0,0,0,0,0,0,0,
0,0,0,0,0,0,0,0,0,0,0.