[layer]
type=Tile Layer 1
data=
0,0,22,1,1,1,1,0,0,0,0,
0,22,1,1,1,1,1,1,0,0,0,
22,1,1,0,0,1,1,1,1,0,0,
1,1,1,0,0,0,1,1,1,1,0,
1,1,1,0,0,0,0,1,1,1,0,
1,1,1,0,0,0,0,1,1,1,0,
1,1,1,0,0,0,1,1,1,1,0,
0,1,1,0,0,1,1,1,1,21,0,
0,0,1,1,1,1,1,1,21,0,0,
0,0,0,0,0,0,0,0,0,0,0,
0,0,0,0,0,0,0,0,0,0,0,
0,0,0,0,0,0,0,0,0,0,0,
0,0,0,0,0,0,0,0,0,0,0.
[layer]
type=Tile Layer 2
data=
0,0,0,80,80,80,80,0,0,0,0,
0,0,79,79,79,79,79,79,0,0,0,
0,70,70,0,0,70,70,70,70,0,0,
69,69,69,0,0,0,69,69,69,69,0,
69,69,69,0,0,0,0,69,69,69,0,
69,69,69,0,0,0,0,69,69,69,0,
69,69,69,0,0,0,69,69,69,69,0,
0,69,69,0,0,69,69,69,69,0,0,
0,0,68,68,68,68,68,68,0,0,0,
0,0,0,0,0,0,0,0,0,0,0,
0,0,0,0,0,0,0,0,0,0,0,
0,0,0,0,0,0,0,0,0,0,0,
0,0,0,0,0,0,0,0,0,0,0.