[layer]
type=Tile Layer 1
data=
1,1,1,1,1,0,3,1,5,3,1,
21,0,2,2,1,1,2,1,2,0,1,
0,1,2,2,1,2,5,2,2,1,1,
2,1,1,2,0,1,7,1,2,2,0,
1,0,1,1,4,1,3,1,5,1,1,
2,1,2,0,1,2,2,6,1,1,1,
2,1,2,0,1,2,1,2,1,2,1,
0,2,1,1,2,7,2,2,4,1,21,
0,1,4,1,0,4,0,1,1,1,1,
21,3,3,0,1,1,1,0,1,1,1,
21,6,0,1,1,1,1,1,0,4,1,
0,0,1,6,2,1,2,2,2,21,1,
0,2,2,3,2,0,1,2,1,1,21,
2,2,1,1,7,2,21,1,2,1,0,
1,2,2,7,1,2,3,0,1,2,21,
1,2,1,2,2,5,2,0,5,24,21,
0,7,1,21,3,0,3,2,2,2,1,
21,0,1,0,4,0,1,0,1,24,0,
6,1,1,1,5,1,1,0,1,24,0,
0,0,1,24,1,21,2,2,2,1,1,
0,0,6,0,1,0,2,0,2,0,21,
2,2,5,2,6,21,1,0,2,0,0,
8,0,1,0,1,21,2,4,2,2,1,
0,0,1,21,2,0,2,0,1,0,0,
2,1,1,2,2,6,2,21,1,7,0,
24,0,1,0,4,0,2,1,2,2,1,
0,0,4,7,1,21,1,0,1,0,0,
2,4,2,1,1,21,2,0,2,0,0,
0,7,1,21,1,0,2,2,1,2,1,
21,0,2,0,2,0,1,0,1,0,0,
2,3,2,1,1,2,1,7,2,0,21,
0,21,1,0,2,0,1,2,1,2,1,
0,0,6,0,1,0,1,0,1,21,0,
2,1,2,1,2,21,1,0,2,0,0,
0,0,1,0,2,21,2,2,1,1,1,
21,0,1,0,1,0,1,0,5,0,0,
1,1,3,1,1,1,1,8,5,21,0,
0,0,1,0,6,21,1,1,6,1,1,
0,0,1,0,4,21,1,0,1,0,0,
1,1,1,3,1,0,4,0,1,0,21,
0,21,3,0,2,0,1,6,2,2,1,
1,3,1,1,1,6,1,1,1,5,0,
6,3,1,1,1,1,1,0,1,0,21,
0,0,1,0,4,21,5,1,1,1,1,
0,21,2,0,1,0,2,0,5,0,0,
1,1,2,2,1,21,2,0,2,0,0,
0,21,1,0,1,0,4,5,1,1,1,
0,21,5,0,1,0,1,0,1,0,0,
2,2,1,2,1,1,3,0,2,21,0,
0,0,1,0,1,21,3,1,6,1,1,
0,0,5,0,2,7,2,0,1,0,0,
1,1,4,1,1,7,3,21,1,0,0,
0,0,1,21,5,0,1,1,4,1,1,
0,0,1,21,1,0,1,0,3,0,0,
1,3,0,1,4,1,1,5,1,1,1,
0,21,1,0,3,0,6,1,1,1,1,
21,0,1,0,1,0,1,0,4,0,0,
1,1,1,1,1,0,5,0,4,0,0,
0,0,6,21,1,0,3,1,1,1,1,
0,0,1,21,2,0,2,0,5,0,0,
5,1,1,2,2,2,4,0,2,21,0,
0,0,1,21,1,0,3,1,1,4,1,
21,0,5,0,1,0,1,0,1,0,0,
1,1,1,1,1,21,3,24,4,0,0,
21,0,1,0,5,0,2,2,2,6,1,
0,0,4,0,1,0,0,0,0,0,21,
0,0,0,0,0,0,0,0,21,0,0,
0,0,0,0,0,0,0,0,0,0,0,
0,0,0,0,0,0,0,0,0,0,0,
0,0,0,0,0,0,0,0,0,0,0.
[layer]
type=Tile Layer 2
data=
168,168,168,168,168,0,168,168,168,168,168,
0,0,168,168,168,168,168,168,168,0,168,
0,181,181,181,181,181,181,181,181,181,181,
271,271,271,271,0,271,0,271,271,271,0,
181,0,181,181,181,181,181,181,181,181,181,
167,167,167,0,167,167,167,167,167,167,167,
167,167,167,0,167,167,167,167,167,167,167,
0,250,250,250,250,0,250,250,250,250,0,
0,180,180,180,0,180,0,180,180,180,180,
0,180,180,0,180,180,180,0,180,180,180,
0,179,0,179,179,179,179,179,0,179,179,
0,0,164,164,164,164,164,164,164,0,164,
0,162,162,162,162,0,162,162,162,162,0,
241,241,241,241,0,241,0,241,241,241,0,
261,261,261,0,261,261,261,0,261,261,0,
259,259,259,259,259,259,259,0,259,0,0,
0,0,258,0,258,0,258,258,258,258,258,
0,0,235,0,235,0,235,0,235,0,0,
234,234,234,234,234,234,234,0,234,0,0,
0,0,234,0,234,0,234,234,234,234,234,
0,0,168,0,168,0,168,0,168,0,0,
167,167,167,167,167,0,167,0,167,0,0,
0,0,249,0,249,0,249,249,249,249,249,
0,0,151,0,151,0,151,0,151,0,0,
225,225,225,225,225,225,225,0,225,0,0,
0,0,223,0,223,0,223,223,223,223,223,
0,0,243,0,243,0,243,0,243,0,0,
161,161,161,161,161,0,161,0,161,0,0,
0,0,240,0,240,0,240,240,240,240,240,
0,0,146,0,146,0,146,0,146,0,0,
217,217,217,217,217,217,217,0,217,0,0,
0,0,144,0,144,0,144,144,144,144,144,
0,0,155,0,155,0,155,0,155,0,0,
154,154,154,154,154,0,154,0,154,0,0,
0,0,152,0,152,0,152,152,152,152,152,
0,0,139,0,139,0,139,0,139,0,0,
207,207,207,207,207,207,207,0,207,0,0,
0,0,137,0,137,0,137,137,137,137,137,
0,0,148,0,148,0,148,0,148,0,0,
146,146,146,146,146,0,146,0,146,0,0,
0,0,145,0,145,0,145,145,145,145,145,
133,133,133,133,133,133,133,133,133,133,0,
133,133,133,133,133,133,133,0,133,0,0,
0,0,132,0,132,0,132,132,132,132,132,
0,0,142,0,142,0,142,0,142,0,0,
140,140,140,140,140,0,140,0,140,0,0,
0,0,139,0,139,0,139,139,139,139,139,
0,0,127,0,127,0,127,0,127,0,0,
126,126,126,126,126,126,126,0,126,0,0,
0,0,125,0,125,0,125,125,125,125,125,
0,0,201,0,201,0,201,0,201,0,0,
201,201,201,201,201,0,201,0,201,0,0,
0,0,133,0,133,0,133,133,133,133,133,
0,0,122,0,122,0,122,0,122,0,0,
121,121,0,121,121,121,121,121,121,121,121,
0,0,121,0,121,0,121,121,121,121,121,
0,0,110,0,110,0,110,0,110,0,0,
109,109,109,109,109,0,109,0,109,0,0,
0,0,109,0,109,0,109,109,109,109,109,
0,0,98,0,98,0,98,0,98,0,0,
97,97,97,97,97,97,97,0,97,0,0,
0,0,96,0,96,0,96,96,96,96,96,
0,0,95,0,95,0,95,0,95,0,0,
141,141,141,141,141,0,141,0,141,0,0,
0,0,93,0,93,0,93,93,93,93,93,
0,0,92,0,92,0,0,0,0,0,0,
0,0,0,0,0,0,0,0,0,0,0,
0,0,0,0,0,0,0,0,0,0,0,
0,0,0,0,0,0,0,0,0,0,0,
0,0,0,0,0,0,0,0,0,0,0.